1,Quincy Acy,190,29,2810,302,623,.485,28,89,.315,274,534,.513,.507,161,213,.756,219,459,678,117,74,74,116,361,793,
2,Jordan Adams,32,0,263,37,92,.402,10,26,.385,27,66,.409,.457,17,28,.607,9,21,30,19,19,7,16,26,101,
3,Steven Adams,202,138,4241,455,831,.548,0,2,.000,455,829,.549,.548,260,472,.551,469,709,1178,144,101,201,219,568,1170,
4,Jeff Adrien,153,17,2148,264,557,.474,0,2,.000,264,555,.476,.474,181,288,.628,221,438,659,100,50,79,91,259,709,
5,Arron Afflalo,624,479,17798,2639,5828,.453,735,1915,.384,1904,3913,.487,.516,1250,1520,.822,312,1574,1886,1225,309,124,757,1289,7263,
6,Alexis Ajinca,235,50,2949,486,948,.513,12,38,.316,474,910,.521,.519,192,239,.803,269,601,870,117,73,143,185,539,1176,
7,Josh Akognon,3,0,9,2,4,.500,1,2,.500,1,2,.500,.625,0,0,,0,1,1,1,0,0,0,3,5,
8,Solomon Alabi,26,0,181,16,51,.314,0,0,,16,51,.314,.314,7,10,.700,22,39,61,5,4,11,8,16,39,
9,Furkan Aldemir,41,9,540,40,78,.513,0,5,.000,40,73,.548,.513,13,27,.481,78,98,176,28,17,16,17,96,93,
10,Cole Aldrich,227,20,2364,315,619,.509,0,0,,315,619,.509,.509,142,191,.743,228,559,787,133,83,163,144,342,772,
11,LaMarcus Aldridge,697,656,24426,5458,11234,.486,61,233,.262,5397,11001,.491,.489,2419,3030,.798,1858,3986,5844,1331,543,709,1112,1800,13396,
12,Cliff Alexander,7,0,31,5,10,.500,0,0,,5,10,.500,.500,0,0,,2,4,6,0,1,2,1,0,10,
13,Lavoy Allen,300,75,5562,696,1492,.466,2,14,.143,694,1478,.470,.467,143,211,.678,560,937,1497,301,96,178,210,575,1537,
14,Tony Allen,709,357,15386,2178,4580,.476,102,363,.281,2076,4217,.492,.487,1220,1701,.717,804,1567,2371,942,995,299,964,1675,5678,
15,Al-Farouq Aminu,431,228,9988,1119,2592,.432,188,607,.310,931,1985,.469,.468,530,731,.725,618,1724,2342,488,413,245,540,813,2956,
16,Lou Amundson,421,42,5466,648,1358,.477,0,3,.000,648,1355,.478,.477,264,599,.441,638,895,1533,187,151,303,293,829,1560,
17,Alan Anderson,287,66,6293,792,1945,.407,305,882,.346,487,1063,.458,.486,381,464,.821,147,516,663,346,175,30,281,542,2270,
18,Chris Andersen,663,31,11793,1293,2428,.533,13,56,.232,1280,2372,.540,.535,1036,1586,.653,1134,2239,3373,323,293,974,501,1297,3635,
19,James Anderson,227,75,3935,483,1176,.411,183,562,.326,300,614,.489,.489,165,216,.764,102,413,515,265,108,49,193,266,1314,
20,Justin Anderson,33,1,286,33,84,.393,11,43,.256,22,41,.537,.458,13,19,.684,3,50,53,10,10,8,13,23,90,
21,Kyle Anderson,82,11,1000,102,242,.421,9,30,.300,93,212,.439,.440,48,67,.716,18,164,182,93,38,25,41,75,261,
22,Ryan Anderson,468,158,12145,2104,4962,.424,954,2515,.379,1150,2447,.470,.520,898,1046,.859,987,1604,2591,418,263,176,478,940,6060,
23,Giannis Antetokounmpo,209,144,6203,862,1800,.479,63,227,.278,799,1573,.508,.496,576,788,.731,249,989,1238,498,187,205,422,603,2363,
24,Thanasis Antetokounmpo,2,0,6,3,4,.750,0,1,.000,3,3,1.000,.750,0,0,,0,1,1,0,0,0,0,2,6,
25,Carmelo Anthony,878,878,31936,7807,17222,.453,980,2852,.344,6827,14370,.475,.482,5356,6602,.811,1650,4165,5815,2745,951,423,2518,2575,21950,
26,Joel Anthony,465,110,6890,384,755,.509,0,0,,384,755,.509,.509,262,395,.663,553,763,1316,96,125,517,222,801,1030,
27,Pero Antic,113,29,1962,231,590,.392,108,344,.314,123,246,.500,.483,138,189,.730,115,283,398,107,37,26,104,258,708,
28,Keith Appling,5,0,27,2,8,.250,0,3,.000,2,5,.400,.250,2,2,1.000,0,1,1,1,1,0,3,5,6,
29,Trevor Ariza,768,467,21780,2849,6663,.428,890,2531,.352,1959,4132,.474,.494,1261,1776,.710,849,2796,3645,1590,1123,250,1118,1563,7849,
30,Hilton Armstrong,292,40,3378,347,693,.501,2,7,.286,345,686,.503,.502,184,316,.582,292,474,766,102,90,142,230,544,880,
31,Metta World Peace,951,836,31037,4623,11125,.416,1136,3331,.341,3487,7794,.447,.467,2538,3548,.715,1146,3244,4390,2610,1701,518,1777,2539,12920,
32,Darrell Arthur,419,92,7602,1183,2664,.444,73,251,.291,1110,2413,.460,.458,324,423,.766,487,1044,1531,320,266,265,346,1066,2763,
33,Omer Asik,399,220,8158,866,1630,.531,0,1,.000,866,1629,.532,.531,536,968,.554,947,2069,3016,252,150,323,499,819,2268,
34,D.J. Augustin,545,170,13193,1722,4281,.402,657,1765,.372,1065,2516,.423,.479,1172,1346,.871,150,839,989,2150,326,22,826,829,5273,
35,Gustavo Ayon,135,41,2251,284,530,.536,0,1,.000,284,529,.537,.536,67,133,.504,188,401,589,173,100,73,122,272,635,
36,Chris Babb,14,0,132,8,30,.267,6,27,.222,2,3,.667,.367,0,0,,4,13,17,3,6,0,3,13,22,
37,Luke Babbitt,239,30,3022,354,887,.399,221,559,.395,133,328,.405,.524,65,90,.722,72,442,514,114,51,36,103,296,994,
38,Cameron Bairstow,32,2,149,11,47,.234,0,4,.000,11,43,.256,.234,8,9,.889,10,23,33,6,4,4,5,24,30,
39,Renaldo Balkman,221,12,3064,368,721,.510,11,64,.172,357,657,.543,.518,147,271,.542,278,491,769,132,164,104,134,421,894,
40,Leandro Barbosa,754,112,16926,3162,6872,.460,937,2411,.389,2225,4461,.499,.528,1179,1440,.819,291,1269,1560,1667,647,109,994,1524,8440,
41,J.J. Barea,635,78,12118,2002,4777,.419,541,1561,.347,1461,3216,.454,.476,709,890,.797,196,1059,1255,2209,246,17,909,948,5254,
42,Andrea Bargnani,550,377,15806,2932,6676,.439,627,1771,.354,2305,4905,.470,.486,1382,1677,.824,530,2011,2541,653,207,470,851,1338,7873,
43,Harrison Barnes,277,216,7641,1032,2323,.444,250,665,.376,782,1658,.472,.498,439,590,.744,276,985,1261,393,206,59,291,518,2753,
44,Matt Barnes,828,314,19287,2492,5601,.445,848,2510,.338,1644,3091,.532,.521,903,1222,.739,961,2764,3725,1419,643,398,1006,2087,6735,
45,Earl Barron,140,31,1985,255,687,.371,3,18,.167,252,669,.377,.373,127,181,.702,188,304,492,63,46,30,107,270,640,
46,Will Barton,226,6,3804,640,1493,.429,124,399,.311,516,1094,.472,.470,291,356,.817,125,582,707,300,139,61,225,253,1695,
47,Brandon Bass,687,283,15391,2388,4833,.494,11,54,.204,2377,4779,.497,.495,1316,1588,.829,1066,2166,3232,569,272,452,675,1292,6103,
48,Nicolas Batum,525,472,16383,2154,4874,.442,842,2329,.362,1312,2545,.516,.528,896,1073,.835,620,2099,2719,1691,481,380,921,997,6046,
49,Jerryd Bayless,493,70,10316,1460,3518,.415,384,1063,.361,1076,2455,.438,.470,886,1072,.826,138,895,1033,1446,315,61,727,1023,4190,
50,Aron Baynes,192,21,2514,393,768,.512,1,7,.143,392,761,.515,.512,182,225,.809,267,468,735,115,35,65,159,360,969,
51,Kent Bazemore,253,68,3927,557,1292,.431,181,499,.363,376,793,.474,.501,241,359,.671,54,555,609,310,177,71,266,369,1536,
52,Bradley Beal,221,197,7300,1329,3123,.426,395,988,.400,934,2135,.437,.489,479,613,.781,177,657,834,657,228,73,408,470,3532,
53,Michael Beasley,433,200,10675,2281,5073,.450,233,680,.343,2048,4393,.466,.473,833,1098,.759,485,1611,2096,571,262,225,765,976,5628,
54,Rodrigue Beaubois,182,54,2896,502,1143,.439,129,397,.325,373,746,.500,.496,153,189,.810,47,291,338,374,124,52,204,312,1286,
55,Marco Belinelli,554,216,12811,1890,4446,.425,733,1926,.381,1157,2520,.459,.508,789,957,.824,127,996,1123,909,324,35,582,863,5302,
56,Jerrelle Benimon,2,0,3,0,0,,0,0,,0,0,,,0,0,,1,2,3,0,0,0,1,0,0,
57,Anthony Bennett,124,3,1631,211,545,.387,22,89,.247,189,456,.414,.407,94,143,.657,107,285,392,65,52,24,87,188,538,
58,Keith Benson,3,0,9,0,1,.000,0,0,,0,1,.000,.000,0,0,,2,1,3,0,0,0,0,0,0,
59,Patrick Beverley,197,146,5364,626,1545,.405,316,855,.370,310,690,.449,.507,194,252,.770,223,449,672,581,225,82,247,575,1762,
60,Sim Bhullar,3,0,3,1,2,.500,0,0,,1,2,.500,.500,0,0,,0,1,1,1,0,1,0,0,2,
61,Andris Biedrins,516,311,11146,1432,2409,.594,0,2,.000,1432,2407,.595,.594,383,766,.500,1190,2441,3631,467,331,580,479,1626,3247,
62,Bismack Biyombo,336,154,7125,566,1133,.500,0,0,,566,1133,.500,.500,388,693,.560,685,1461,2146,100,84,524,299,750,1520,
63,Nemanja Bjelica,46,0,824,73,170,.429,34,96,.354,39,74,.527,.529,25,38,.658,33,116,149,62,20,16,34,119,205,
64,Tarik Black,83,39,1443,187,325,.575,0,1,.000,187,324,.577,.575,75,143,.524,163,289,452,47,24,32,58,202,449,
65,DeJuan Blair,423,179,7053,1242,2371,.524,0,9,.000,1242,2362,.526,.524,381,627,.608,810,1343,2153,349,316,127,471,1001,2865,
66,Steve Blake,842,345,20305,2017,5029,.401,1014,2638,.384,1003,2391,.419,.502,492,633,.777,247,1525,1772,3333,577,61,1183,1250,5540,
67,Andray Blatche,564,191,12462,2327,4981,.467,52,219,.237,2275,4762,.478,.472,1000,1380,.725,1043,1981,3024,798,492,458,914,1382,5706,
68,Eric Bledsoe,352,190,9133,1464,3274,.447,255,765,.333,1209,2509,.482,.486,907,1161,.781,285,978,1263,1506,491,173,905,663,4090,
69,Vander Blue,5,1,89,11,34,.324,2,11,.182,9,23,.391,.353,3,10,.300,2,10,12,9,3,0,8,5,27,
70,Keith Bogans,671,333,14527,1482,3759,.394,714,2020,.353,768,1739,.442,.489,579,809,.716,391,1426,1817,866,429,68,574,1223,4257,
71,Bojan Bogdanovic,132,45,3269,451,1020,.442,166,461,.360,285,559,.510,.524,141,172,.820,79,307,386,123,56,12,145,180,1209,
72,Andrew Bogut,619,605,18418,2853,5351,.533,2,23,.087,2851,5328,.535,.533,816,1466,.557,1621,3986,5607,1404,407,1008,1102,1957,6524,
73,Matt Bonner,782,111,13264,1737,3742,.464,791,1906,.415,946,1836,.515,.570,337,432,.780,622,1740,2362,549,284,212,298,1298,4602,
74,Devin Booker,48,23,1118,176,391,.450,56,139,.403,120,252,.476,.522,103,125,.824,12,92,104,84,26,7,74,124,511,
75,Trevor Booker,364,112,7448,992,1934,.513,36,118,.305,956,1816,.526,.522,341,552,.618,728,1179,1907,312,240,214,337,742,2361,
76,Carlos Boozer,861,775,26901,5847,11221,.521,1,14,.071,5846,11207,.522,.521,2281,3158,.722,2037,6155,8192,1928,765,346,1824,2612,13976,
77,Chris Bosh,893,881,31936,6209,12581,.494,305,910,.335,5904,11671,.506,.506,4466,5591,.799,1927,5665,7592,1795,730,932,1807,2159,17189,
78,Avery Bradley,332,259,8905,1507,3457,.436,372,1023,.364,1135,2434,.466,.490,329,422,.780,192,651,843,529,337,70,443,686,3715,
79,Elton Brand,1041,867,34685,6568,13113,.501,2,20,.100,6566,13093,.501,.501,3619,4920,.736,3295,5682,8977,2166,931,1820,2049,3083,16757,
80,Corey Brewer,602,278,15262,2276,5360,.425,418,1441,.290,1858,3919,.474,.464,1047,1467,.714,493,1326,1819,1021,824,173,806,1378,6017,
81,Ronnie Brewer,502,304,11539,1554,3169,.490,90,355,.254,1464,2814,.520,.505,742,1099,.675,451,976,1427,828,622,120,390,545,3940,
82,Aaron Brooks,521,182,11915,2037,4927,.413,737,1990,.370,1300,2937,.443,.488,858,1016,.844,223,741,964,1699,313,77,883,1052,5669,
83,MarShon Brooks,164,49,2876,486,1100,.442,75,230,.326,411,870,.472,.476,214,286,.748,112,246,358,232,100,35,211,230,1261,
84,Anthony Brown,25,8,474,32,101,.317,17,57,.298,15,44,.341,.401,14,17,.824,7,48,55,12,10,5,14,26,95,
85,Jabari Brown,19,5,568,70,170,.412,23,62,.371,47,108,.435,.479,64,85,.753,3,33,36,40,12,2,32,33,227,
86,Lorenzo Brown,63,7,834,86,233,.369,10,66,.152,76,167,.455,.391,24,36,.667,22,83,105,142,44,10,55,72,206,
87,Markel Brown,82,33,1182,114,319,.357,34,116,.293,80,203,.394,.411,79,99,.798,22,127,149,74,42,17,45,102,341,
88,Shannon Brown,408,60,7329,1198,2854,.420,276,831,.332,922,2023,.456,.468,446,553,.807,177,583,760,458,284,90,378,538,3118,
89,Kobe Bryant,1325,1177,48093,11583,25838,.448,1784,5400,.330,9799,20438,.479,.483,8293,9913,.837,1491,5500,6991,6274,1925,636,3978,3324,33243,
90,Chase Budinger,382,50,7703,1152,2694,.428,407,1147,.355,745,1547,.482,.503,401,501,.800,220,971,1191,452,204,62,291,461,3112,
91,Reggie Bullock,97,2,822,68,210,.324,38,129,.295,30,81,.370,.414,16,21,.762,15,97,112,23,20,5,23,50,190,
92,Trey Burke,195,111,5708,938,2439,.385,309,939,.329,629,1500,.419,.448,262,323,.811,85,426,511,850,138,26,317,327,2447,
93,Alec Burks,256,42,5928,950,2201,.432,153,423,.362,797,1778,.448,.466,687,915,.751,188,560,748,500,164,41,375,521,2740,
94,Caron Butler,873,732,28243,4582,10559,.434,744,2134,.349,3838,8425,.456,.469,2483,2932,.847,1101,3275,4376,2000,1159,215,1593,2117,12391,
95,Jimmy Butler,304,200,9414,1324,2975,.445,236,709,.333,1088,2266,.480,.485,1183,1461,.810,413,929,1342,721,411,139,366,421,4067,
96,Rasual Butler,799,266,17109,2280,5661,.403,908,2510,.362,1372,3151,.435,.483,592,791,.748,294,1628,1922,655,284,403,526,1129,6060,
97,Dwight Buycks,20,0,269,33,88,.375,12,28,.429,21,60,.350,.443,17,19,.895,6,29,35,24,11,0,22,14,95,
98,Derrick Byars,2,0,37,3,11,.273,0,6,.000,3,5,.600,.273,4,4,1.000,6,5,11,1,2,0,0,2,10,
99,Andrew Bynum,418,319,10690,1917,3446,.556,1,9,.111,1916,3437,.557,.556,987,1431,.690,1007,2214,3221,490,133,657,644,1028,4822,
100,Will Bynum,360,29,6611,1117,2529,.442,84,309,.272,1033,2220,.465,.458,603,755,.799,125,436,561,1185,256,29,578,670,2921,
101,Bruno Caboclo,11,0,27,4,14,.286,2,3,.667,2,11,.182,.357,0,0,,1,2,3,0,1,1,5,3,10,
102,Nick Calathes,129,7,2011,246,558,.441,30,104,.288,216,454,.476,.468,68,117,.581,42,201,243,353,129,13,162,217,590,
103,Jose Calderon,727,525,20944,2782,5857,.475,816,1984,.411,1966,3873,.508,.545,868,992,.875,258,1601,1859,4738,648,63,1195,1249,7248,
104,Kentavious Caldwell-Pope,212,173,6017,839,2066,.406,288,873,.330,551,1193,.462,.476,279,367,.760,127,473,600,255,243,45,195,422,2245,
105,Isaiah Canaan,121,45,2463,339,921,.368,222,607,.366,117,314,.373,.489,163,203,.803,37,188,225,216,76,17,153,198,1063,
106,Clint Capela,65,35,1196,176,313,.562,0,0,,176,313,.562,.562,62,170,.365,148,252,400,39,44,74,58,156,414,
107,DeMarre Carroll,339,186,7569,1003,2213,.453,286,778,.368,717,1435,.500,.518,388,539,.720,404,880,1284,392,339,78,250,667,2680,
108,Michael Carter-Williams,184,170,6031,1016,2467,.412,104,405,.257,912,2062,.442,.433,554,800,.693,210,824,1034,1148,316,105,636,520,2690,
109,Vince Carter,1249,951,40798,8601,19594,.439,1898,5097,.372,6703,14497,.462,.487,4619,5778,.799,1535,4293,5828,4345,1337,767,2404,3453,23719,
110,Omri Casspi,442,134,9583,1352,3070,.440,430,1168,.368,922,1902,.485,.510,565,833,.678,376,1446,1822,520,285,98,481,724,3699,
111,Willie Cauley-Stein,39,29,797,101,167,.605,0,0,,101,167,.605,.605,41,70,.586,83,133,216,16,24,45,27,92,243,
112,Mario Chalmers,569,388,15553,1735,4104,.423,694,1934,.359,1041,2170,.480,.507,939,1203,.781,191,1208,1399,2174,848,85,1068,1541,5103,
113,Tyson Chandler,965,762,27512,3122,5302,.589,0,10,.000,3122,5292,.590,.589,2153,3339,.645,3067,5875,8942,820,540,1237,1442,2840,8397,
114,Wilson Chandler,445,343,13833,2368,5356,.442,580,1709,.339,1788,3647,.490,.496,782,1007,.777,502,1854,2356,784,335,312,645,1277,6098,
115,Will Cherry,8,0,69,5,19,.263,2,9,.222,3,10,.300,.316,3,6,.500,1,4,5,8,6,1,4,10,15,
116,Josh Childress,391,70,10432,1343,2571,.522,99,301,.329,1244,2270,.548,.542,763,980,.779,732,1118,1850,609,339,184,439,725,3548,
117,Dionte Christmas,31,0,198,22,62,.355,9,31,.290,13,31,.419,.427,18,24,.750,13,25,38,8,2,3,6,19,71,
118,Patrick Christopher,4,1,29,3,12,.250,0,4,.000,3,8,.375,.250,0,0,,2,4,6,0,1,0,1,6,6,
119,Earl Clark,261,54,3630,453,1125,.403,82,250,.328,371,875,.424,.439,150,226,.664,195,583,778,134,83,136,175,323,1138,
120,Ian Clark,96,1,775,115,275,.418,46,122,.377,69,153,.451,.502,33,37,.892,16,64,80,72,28,15,54,82,309,
121,Jordan Clarkson,112,91,3189,588,1313,.448,93,280,.332,495,1033,.479,.483,248,306,.810,117,281,398,341,109,19,193,226,1517,
122,Victor Claver,80,16,1072,100,251,.398,34,116,.293,66,135,.489,.466,24,41,.585,43,135,178,56,30,16,58,103,258,
123,Norris Cole,337,50,7602,939,2302,.408,195,606,.322,744,1696,.439,.450,260,354,.734,76,576,652,913,263,33,492,636,2333,
124,Darren Collison,469,303,13708,2161,4638,.466,353,958,.368,1808,3680,.491,.504,1182,1391,.850,226,1031,1257,2273,518,70,1010,773,5857,
125,Nick Collison,859,175,18220,2172,4079,.532,21,100,.210,2151,3979,.541,.535,902,1240,.727,1736,2867,4603,904,441,465,849,2458,5267,
126,Mike Conley,628,599,20411,3108,7069,.440,723,1938,.373,2385,5131,.465,.491,1538,1906,.807,264,1533,1797,3522,953,116,1268,1260,8477,
127,Pat Connaughton,21,0,59,4,21,.190,2,10,.200,2,11,.182,.238,2,2,1.000,5,9,14,3,2,0,6,3,12,
128,Brian Cook,421,74,5649,915,2083,.439,262,686,.382,653,1397,.467,.502,220,281,.783,308,807,1115,252,135,134,252,789,2312,
129,Daequan Cook,328,49,5993,758,2056,.369,442,1232,.359,316,824,.383,.476,156,192,.813,75,628,703,243,120,48,177,478,2114,
130,Jack Cooley,16,0,87,9,22,.409,0,0,,9,22,.409,.409,9,21,.429,10,15,25,1,6,3,3,23,27,
131,Chris Copeland,171,26,2111,366,858,.427,154,422,.365,212,436,.486,.516,112,149,.752,65,207,272,107,32,30,129,237,998,
132,Bryce Cotton,18,0,192,31,77,.403,7,23,.304,24,54,.444,.448,15,18,.833,3,15,18,18,7,0,17,8,84,
133,DeMarcus Cousins,394,372,12366,2852,6197,.460,63,218,.289,2789,5979,.466,.465,2030,2782,.730,1209,3006,4215,1061,544,449,1332,1533,7797,
134,Marcus Cousin,4,0,18,2,3,.667,0,0,,2,3,.667,.667,0,0,,0,3,3,0,0,1,1,1,4,
135,Robert Covington,121,79,3176,467,1199,.389,265,735,.361,202,464,.435,.500,260,321,.810,107,471,578,167,169,58,234,340,1459,
136,Allen Crabbe,119,17,2172,305,670,.455,108,293,.369,197,377,.523,.536,77,91,.846,25,197,222,108,69,24,67,221,795,
137,Jamal Crawford,1074,430,33240,5773,14082,.410,1882,5403,.348,3891,8679,.448,.477,3245,3769,.861,411,2171,2582,3842,1022,232,2107,1692,16673,
138,Jordan Crawford,257,99,6348,1169,2885,.405,285,932,.306,884,1953,.453,.455,509,615,.828,147,518,665,813,184,20,499,400,3132,
139,Jae Crowder,293,96,6021,769,1809,.425,268,818,.328,501,991,.506,.499,343,446,.769,205,751,956,350,291,91,205,509,2149,
140,Dante Cunningham,482,84,9764,1257,2675,.470,33,129,.256,1224,2546,.481,.476,271,420,.645,597,1230,1827,324,335,253,242,870,2818,
141,Jared Cunningham,80,3,550,56,159,.352,17,55,.309,39,104,.375,.406,52,79,.658,6,41,47,38,19,2,29,68,181,
142,Seth Curry,29,0,274,29,70,.414,14,33,.424,15,37,.405,.514,19,25,.760,3,19,22,19,12,1,12,17,91,
143,Stephen Curry,466,460,16251,3607,7585,.476,1436,3244,.443,2171,4341,.500,.570,1553,1722,.902,320,1666,1986,3195,824,99,1483,1197,10203,
144,Samuel Dalembert,886,694,21646,2810,5393,.521,1,12,.083,2809,5381,.522,.521,1193,1689,.706,2289,4653,6942,465,437,1546,1271,2601,6814,
145,Troy Daniels,79,1,758,130,311,.418,90,213,.423,40,98,.408,.563,15,21,.714,13,60,73,37,12,2,40,73,365,
146,Gigi Datome,55,1,447,77,186,.414,25,79,.316,52,107,.486,.481,9,11,.818,17,58,75,20,8,8,20,35,188,
147,Brandon Davies,78,6,998,109,265,.411,10,44,.227,99,221,.448,.430,58,90,.644,76,116,192,58,42,15,64,151,286,
148,Anthony Davis,245,240,8294,1927,3711,.519,26,103,.252,1901,3608,.527,.523,1112,1427,.779,644,1712,2356,402,322,606,386,610,4992,
149,Ed Davis,407,82,8696,1219,2172,.561,0,1,.000,1219,2171,.561,.561,463,822,.563,928,1678,2606,344,215,394,316,980,2901,
150,Glen Davis,514,121,10865,1614,3611,.447,10,55,.182,1604,3556,.451,.448,873,1247,.700,731,1505,2236,457,357,173,528,1238,4111,
151,Andre Dawkins,4,0,22,1,6,.167,1,6,.167,0,0,,.250,0,0,,0,2,2,1,0,0,1,3,3,
152,Branden Dawson,2,0,13,1,3,.333,0,0,,1,3,.333,.333,0,0,,2,1,3,0,0,1,0,2,2,
153,Eric Dawson,4,0,39,7,12,.583,0,0,,7,12,.583,.583,1,2,.500,5,5,10,0,1,2,3,6,15,
154,Austin Daye,293,29,4132,567,1410,.402,188,535,.351,379,875,.433,.469,200,257,.778,143,621,764,212,116,117,204,480,1522,
155,Nando De Colo,119,9,1414,169,394,.429,49,135,.363,120,259,.463,.491,66,79,.835,37,174,211,203,63,12,116,135,453,
156,Dewayne Dedmon,123,25,1579,165,320,.516,0,1,.000,165,319,.517,.516,82,133,.617,185,341,526,20,33,99,84,267,412,
157,Bryce Dejean-Jones,11,8,219,24,56,.429,10,26,.385,14,30,.467,.518,11,21,.524,8,31,39,12,9,1,7,12,69,
158,Sam Dekker,3,0,6,0,0,,0,0,,0,0,,,0,0,,0,1,1,0,1,0,0,0,0,
159,Carlos Delfino,507,170,11580,1472,3669,.401,678,1856,.365,794,1813,.438,.494,493,650,.758,287,1528,1815,887,461,88,509,827,4115,
160,Matthew Dellavedova,185,28,3863,371,929,.399,189,470,.402,182,459,.397,.501,104,127,.819,93,270,363,613,91,12,192,379,1035,
161,Luol Deng,795,748,28094,4742,10375,.457,562,1674,.336,4180,8701,.480,.484,2306,2986,.772,1318,3554,4872,1878,783,403,1363,1364,12352,
162,DeMar DeRozan,495,483,16730,3148,7118,.442,189,676,.280,2959,6442,.459,.456,2340,2851,.821,362,1553,1915,1270,464,147,912,1157,8825,
163,Yakhouba Diawara,187,56,2614,233,653,.357,122,405,.301,111,248,.448,.450,67,103,.650,77,181,258,122,52,16,72,276,655,
164,Boris Diaw,968,528,27103,3601,7279,.495,451,1316,.343,3150,5963,.528,.526,1014,1417,.716,1198,3219,4417,3469,624,493,1776,2159,8667,
165,Gorgui Dieng,187,75,4390,561,1092,.514,4,16,.250,557,1076,.518,.516,376,491,.766,430,860,1290,272,160,228,282,440,1502,
166,Spencer Dinwiddie,43,1,566,65,204,.319,13,72,.181,52,132,.394,.350,42,53,.792,4,53,57,117,21,6,38,69,185,
167,Ike Diogu,225,18,2795,488,958,.509,1,2,.500,487,956,.509,.510,371,472,.786,275,414,689,69,36,65,200,425,1348,
168,Joey Dorsey,130,26,1488,142,266,.534,0,1,.000,142,265,.536,.534,60,160,.375,198,315,513,55,67,44,86,256,344,
169,Chris Douglas-Roberts,222,61,4381,574,1309,.439,84,255,.329,490,1054,.465,.471,339,408,.831,83,389,472,254,128,55,200,287,1571,
170,Toney Douglas,340,47,6315,930,2297,.405,386,1084,.356,544,1213,.448,.489,295,360,.819,184,523,707,733,294,21,344,649,2541,
171,Goran Dragic,546,310,14466,2453,5224,.470,558,1554,.359,1895,3670,.516,.523,1201,1606,.748,397,1091,1488,2504,560,103,1179,1233,6665,
172,Zoran Dragic,16,1,75,11,30,.367,3,14,.214,8,16,.500,.417,3,5,.600,5,3,8,5,2,0,5,6,28,
173,Larry Drew II,12,1,219,20,58,.345,4,26,.154,16,32,.500,.379,2,3,.667,1,14,15,45,6,0,25,13,46,
174,Andre Drummond,277,227,8186,1566,2815,.556,3,11,.273,1563,2804,.557,.557,483,1265,.382,1318,2121,3439,165,321,461,402,871,3618,
175,Jared Dudley,644,244,15714,2000,4255,.470,679,1685,.403,1321,2570,.514,.550,810,1098,.738,701,1495,2196,1011,569,109,581,1139,5489,
176,Tim Duncan,1369,1367,46810,10207,20169,.506,30,168,.179,10177,20001,.509,.507,5863,8416,.697,3810,11120,14930,4177,1011,2994,3355,3268,26307,
177,Mike Dunleavy,905,555,25837,3770,8532,.442,1215,3232,.376,2555,5300,.482,.513,1811,2253,.804,672,3343,4015,2099,691,307,1317,1859,10566,
178,Kevin Durant,615,615,23294,5649,11706,.483,1069,2812,.380,4580,8894,.515,.528,4449,5046,.882,495,3804,4299,2209,750,610,1976,1156,16816,
179,Cleanthony Early,49,7,681,79,220,.359,23,88,.261,56,132,.424,.411,36,48,.750,22,77,99,37,25,13,41,60,217,
180,Devin Ebanks,63,15,711,82,213,.385,8,36,.222,74,177,.418,.404,52,72,.722,51,71,122,24,18,12,35,56,224,
181,Jarell Eddie,14,0,79,13,38,.342,12,32,.375,1,6,.167,.500,4,4,1.000,1,12,13,2,2,1,1,3,42,
182,Shane Edwards,2,0,12,1,3,.333,0,0,,1,3,.333,.333,0,0,,1,1,2,0,0,0,1,1,2,
183,Wayne Ellington,430,90,8341,1151,2790,.413,416,1108,.375,735,1682,.437,.487,303,359,.844,148,752,900,455,200,28,304,455,3021,
184,Monta Ellis,731,652,26066,5334,11784,.453,659,2109,.312,4675,9675,.483,.481,2516,3255,.773,481,2078,2559,3494,1278,243,2055,1736,13843,
185,Melvin Ely,375,55,6005,783,1702,.460,0,3,.000,783,1699,.461,.460,426,682,.625,448,767,1215,261,99,209,392,765,1992,
186,Kim English,41,0,407,42,112,.375,14,50,.280,28,62,.452,.438,21,29,.724,8,29,37,26,16,3,19,46,119,
187,James Ennis,72,3,1086,104,255,.408,33,100,.330,71,155,.458,.473,84,102,.824,53,128,181,51,28,19,41,91,325,
188,Tyler Ennis,57,6,619,76,204,.373,16,57,.281,60,147,.408,.412,14,19,.737,10,49,59,97,24,6,56,59,182,
189,Jeremy Evans,248,9,2618,362,638,.567,5,25,.200,357,613,.582,.571,145,211,.687,238,402,640,107,90,121,84,290,874,
190,Reggie Evans,809,372,15572,1107,2379,.465,1,11,.091,1106,2368,.467,.466,1074,2036,.528,1984,3781,5765,458,566,115,897,1895,3289,
191,Tyreke Evans,433,370,14445,2737,6139,.446,267,928,.288,2470,5211,.474,.468,1479,1954,.757,410,1707,2117,2293,584,178,1193,1035,7220,
192,Dante Exum,82,41,1817,145,416,.349,83,264,.314,62,152,.408,.448,20,32,.625,27,104,131,198,41,14,118,147,393,
193,Festus Ezeli,164,59,2334,267,518,.515,0,0,,267,518,.515,.515,158,283,.558,284,418,702,62,47,165,131,326,692,
194,Kenneth Faried,328,312,8785,1627,2997,.543,1,12,.083,1626,2985,.545,.543,770,1195,.644,1045,1809,2854,354,268,301,487,877,4025,
195,Jordan Farmar,490,30,9514,1414,3340,.423,563,1505,.374,851,1835,.464,.508,375,511,.734,156,774,930,1407,374,54,674,690,3766,
196,Vitor Faverani,37,8,488,64,147,.435,12,40,.300,52,107,.486,.476,24,37,.649,42,86,128,16,14,27,41,74,164,
197,Derrick Favors,402,224,10312,1819,3551,.512,1,14,.071,1818,3537,.514,.512,928,1403,.661,1010,1913,2923,414,313,540,615,1174,4567,
198,Cristiano Felicio,7,0,19,1,2,.500,0,1,.000,1,1,1.000,.500,1,2,.500,0,1,1,4,0,0,1,2,3,
199,Carrick Felix,7,0,38,7,14,.500,2,5,.400,5,9,.556,.571,3,4,.750,1,5,6,4,0,0,4,4,19,
200,Raymond Felton,750,637,24654,3516,8529,.412,766,2311,.331,2750,6218,.442,.457,1568,1993,.787,475,1902,2377,4550,997,155,1791,1573,9366,
201,Kyrylo Fesenko,135,7,1107,125,252,.496,0,2,.000,125,250,.500,.496,55,134,.410,97,172,269,40,19,53,66,224,305,
202,Landry Fields,255,176,6010,684,1446,.473,120,361,.332,564,1085,.520,.515,243,365,.666,248,844,1092,419,212,45,270,310,1731,
203,Gary Forbes,111,13,1504,236,544,.434,48,141,.340,188,403,.467,.478,125,178,.702,55,163,218,103,47,10,100,133,645,
204,Evan Fournier,224,84,5231,814,1851,.440,300,777,.386,514,1074,.479,.521,340,442,.769,89,450,539,414,160,12,298,491,2268,
205,Randy Foye,656,392,17423,2534,6276,.404,1012,2733,.370,1522,3543,.430,.484,1141,1339,.852,228,1252,1480,1928,480,198,998,1437,7221,
206,Jamaal Franklin,24,0,174,17,41,.415,6,13,.462,11,28,.393,.488,2,2,1.000,5,20,25,9,4,3,14,27,42,
207,Tim Frazier,46,4,511,41,121,.339,8,34,.235,33,87,.379,.372,18,36,.500,17,50,67,102,18,1,52,57,108,
208,Jimmer Fredette,233,7,3143,515,1252,.411,192,505,.380,323,747,.432,.488,187,213,.878,52,184,236,323,91,11,217,216,1409,
209,Joel Freeland,151,9,1821,209,455,.459,0,2,.000,209,453,.461,.459,59,81,.728,190,328,518,65,32,56,74,255,477,
210,Channing Frye,701,420,16892,2475,5645,.438,798,2063,.387,1677,3582,.468,.509,773,943,.820,702,2730,3432,735,392,477,687,1948,6521,
211,Dan Gadzuric,527,164,7793,1049,2100,.500,0,8,.000,1049,2092,.501,.500,367,737,.498,910,1416,2326,196,242,448,357,1250,2465,
212,Danilo Gallinari,392,322,12018,1759,4235,.415,704,1921,.366,1055,2314,.456,.498,1597,1864,.857,308,1496,1804,754,329,186,512,774,5819,
213,Langston Galloway,100,47,2837,367,898,.409,118,325,.363,249,573,.435,.474,123,154,.799,68,324,392,278,99,25,98,248,975,
214,Francisco Garcia,549,137,11853,1564,3659,.427,581,1627,.357,983,2032,.484,.507,614,768,.799,278,1122,1400,747,441,388,545,1229,4323,
215,Kevin Garnett,1462,1425,50418,10505,21142,.497,174,632,.275,10331,20510,.504,.501,4887,6190,.789,3209,11453,14662,5445,1859,2037,3179,3561,26071,
216,Diante Garrett,90,0,1197,117,314,.373,39,111,.351,78,203,.384,.435,15,22,.682,16,96,112,151,51,5,91,80,288,
217,Marc Gasol,569,562,19190,3072,6102,.503,12,66,.182,3060,6036,.507,.504,1990,2604,.764,1124,3307,4431,1748,527,872,1128,1739,8146,
218,Pau Gasol,1032,1019,36474,7213,14102,.511,66,219,.301,7147,13883,.515,.514,4364,5780,.755,2782,7006,9788,3356,541,1728,2371,2322,18856,
219,Rudy Gay,699,661,24968,4902,10834,.452,726,2114,.343,4176,8720,.479,.486,2388,3006,.794,1052,3064,4116,1587,918,573,1686,1745,12918,
220,Alonzo Gee,383,208,8459,950,2210,.430,184,559,.329,766,1651,.464,.471,543,709,.766,363,899,1262,412,358,96,423,731,2627,
221,Mickael Gelabale,145,27,2348,263,560,.470,43,136,.316,220,424,.519,.508,101,124,.815,107,223,330,115,50,35,92,186,670,
222,Paul George,345,297,11059,1939,4571,.424,639,1745,.366,1300,2826,.460,.494,1160,1390,.835,300,1839,2139,1051,567,156,851,912,5677,
223,Taj Gibson,486,153,12109,1817,3724,.488,1,22,.045,1816,3702,.491,.488,794,1152,.689,1161,1913,3074,466,247,624,604,1280,4429,
224,Manu Ginobili,908,349,23981,4168,9264,.450,1323,3592,.368,2845,5672,.502,.521,3166,3831,.826,634,2745,3379,3620,1249,284,1889,1936,12825,
225,Mickell Gladness,26,7,252,25,59,.424,0,0,,25,59,.424,.424,6,12,.500,14,44,58,5,4,20,7,32,56,
226,Rudy Gobert,159,68,3656,414,701,.591,0,2,.000,414,699,.592,.591,293,484,.605,415,850,1265,169,101,308,198,328,1121,
227,Ryan Gomes,487,371,13463,1891,4249,.445,334,956,.349,1557,3293,.473,.484,810,1014,.799,617,1622,2239,712,351,78,550,942,4926,
228,Drew Gooden,781,500,20092,3427,7416,.462,88,333,.264,3339,7083,.471,.468,1699,2235,.760,1876,3732,5608,896,543,472,1157,1949,8641,
229,Archie Goodwin,127,14,1749,260,612,.425,32,130,.246,228,482,.473,.451,185,263,.703,68,176,244,140,54,29,152,146,737,
230,Aaron Gordon,98,19,1908,240,524,.458,36,125,.288,204,399,.511,.492,122,175,.697,144,335,479,106,51,61,80,175,638,
231,Ben Gordon,744,269,20366,3931,9092,.432,1171,2921,.401,2760,6171,.447,.497,2051,2394,.857,333,1518,1851,1868,508,114,1551,1720,11084,
232,Drew Gordon,9,0,71,8,19,.421,0,3,.000,8,16,.500,.421,1,2,.500,7,11,18,2,1,0,8,7,17,
233,Eric Gordon,413,394,14038,2334,5369,.435,765,2003,.382,1569,3366,.466,.506,1426,1753,.813,195,844,1039,1360,439,117,921,826,6859,
234,Marcin Gortat,564,350,14434,2439,4446,.549,3,17,.176,2436,4429,.550,.549,845,1235,.684,1173,3197,4370,540,281,701,652,1217,5726,
235,Andrew Goudelock,41,0,425,68,176,.386,28,75,.373,40,101,.396,.466,11,12,.917,6,26,32,20,4,0,21,32,175,
236,Danny Granger,586,431,18487,3332,7672,.434,1006,2644,.380,2326,5028,.463,.500,2185,2577,.848,674,2214,2888,1097,561,481,1098,1628,9855,
237,Jerami Grant,116,43,2686,284,720,.394,71,253,.281,213,467,.456,.444,239,378,.632,114,321,435,161,78,151,151,289,878,
238,Jerian Grant,51,0,802,83,238,.349,8,54,.148,75,184,.408,.366,65,83,.783,14,72,86,124,27,5,53,69,239,
239,Danny Green,376,310,9256,1226,2838,.432,700,1700,.412,526,1138,.462,.555,334,404,.827,212,1071,1283,593,367,291,398,597,3486,
240,Donte Greene,253,82,4259,585,1441,.406,165,542,.304,420,899,.467,.463,206,294,.701,140,460,600,183,111,116,222,373,1541,
241,Draymond Green,291,143,7085,864,2005,.431,248,723,.343,616,1282,.480,.493,405,594,.682,348,1453,1801,865,335,261,424,796,2381,
242,Erick Green,52,1,452,66,175,.377,15,52,.288,51,123,.415,.420,12,14,.857,10,27,37,42,13,0,14,30,159,
243,Gerald Green,475,111,9740,1765,4180,.422,638,1762,.362,1127,2418,.466,.499,671,824,.814,250,955,1205,487,257,147,604,939,4839,
244,JaMychal Green,73,4,878,130,252,.516,10,24,.417,120,228,.526,.536,62,80,.775,75,159,234,23,21,19,61,133,332,
245,Jeff Green,609,463,19651,3163,7208,.439,629,1852,.340,2534,5356,.473,.482,1642,2075,.791,634,2381,3015,1014,490,359,1039,1435,8597,
246,Willie Green,731,297,14783,2417,5682,.425,517,1494,.346,1900,4188,.454,.471,708,925,.765,242,1061,1303,1018,393,108,705,1259,6059,
247,Blake Griffin,405,405,14369,3407,6526,.522,42,154,.273,3365,6372,.528,.525,1893,2868,.660,1041,2852,3893,1633,390,246,1005,1245,8749,
248,Jorge Gutierrez,35,3,419,47,95,.495,3,15,.200,44,80,.550,.511,18,25,.720,8,39,47,52,16,1,26,62,115,
249,P.J. Hairston,93,45,1625,186,545,.341,103,335,.307,83,210,.395,.436,65,78,.833,40,180,220,50,45,20,46,167,540,
250,Jordan Hamilton,140,17,1796,293,723,.405,124,339,.366,169,384,.440,.491,55,82,.671,77,290,367,102,65,31,85,120,765,
251,Justin Hamilton,49,14,784,94,198,.475,13,40,.325,81,158,.513,.508,44,52,.846,61,80,141,36,32,30,30,78,245,
252,Ben Hansbrough,28,0,200,15,45,.333,6,23,.261,9,22,.409,.400,21,27,.778,2,16,18,21,7,2,18,23,57,
253,Tyler Hansbrough,413,50,7161,939,2142,.438,3,22,.136,936,2120,.442,.439,972,1315,.739,740,1053,1793,180,206,91,318,857,2853,
254,Tim Hardaway,175,31,3912,608,1500,.405,263,761,.346,345,739,.467,.493,249,303,.822,36,281,317,218,73,24,137,281,1728,
255,James Harden,507,294,16670,3070,6954,.441,1039,2825,.368,2031,4129,.492,.516,3249,3796,.856,361,1921,2282,2395,732,222,1477,1269,10428,
256,Maurice Harkless,253,107,5493,657,1436,.458,124,409,.303,533,1027,.519,.501,215,377,.570,284,585,869,199,246,140,226,416,1653,
257,Justin Harper,14,0,84,9,31,.290,2,13,.154,7,18,.389,.323,0,1,.000,3,9,12,2,2,3,6,5,20,
258,Josh Harrellson,75,4,888,105,240,.438,33,95,.347,72,145,.497,.506,22,35,.629,80,147,227,26,30,36,33,96,265,
259,Montrezl Harrell,28,1,279,37,57,.649,0,0,,37,57,.649,.649,20,38,.526,18,30,48,10,7,7,13,40,94,
260,Aaron Harrison,13,0,55,2,10,.200,1,3,.333,1,7,.143,.250,2,6,.333,3,5,8,0,4,0,2,3,7,
261,Devin Harris,757,445,19969,2968,6782,.438,609,1879,.324,2359,4903,.481,.483,2401,3022,.795,250,1481,1731,3424,851,154,1465,1735,8946,
262,Elias Harris,2,0,11,0,1,.000,0,0,,0,1,.000,.000,0,0,,1,0,1,1,1,0,0,0,0,
263,Gary Harris,103,54,2214,271,661,.410,83,273,.304,188,388,.485,.473,94,119,.790,51,150,201,113,98,18,103,165,719,
264,Joe Harris,56,1,508,49,124,.395,32,88,.364,17,36,.472,.524,9,15,.600,7,37,44,28,7,2,28,63,139,
265,Manny Harris,89,20,1569,196,509,.385,53,148,.358,143,361,.396,.437,122,164,.744,54,190,244,127,48,14,99,103,567,
266,Mike Harris,54,0,496,70,151,.464,0,5,.000,70,146,.479,.464,43,55,.782,51,65,116,12,27,12,30,68,183,
267,Terrel Harris,42,1,455,33,110,.300,8,47,.170,25,63,.397,.336,21,31,.677,22,55,77,35,11,5,42,51,95,
268,Tobias Harris,275,191,7607,1337,2887,.463,206,647,.318,1131,2240,.505,.499,657,833,.789,336,1249,1585,396,202,139,368,533,3537,
269,Udonis Haslem,802,498,21183,2606,5300,.492,3,30,.100,2603,5270,.494,.492,1212,1599,.758,1590,4055,5645,714,415,246,790,1995,6427,
270,Spencer Hawes,620,367,14608,2299,5040,.456,328,935,.351,1971,4105,.480,.489,620,876,.708,941,2725,3666,1174,248,615,915,1618,5546,
271,Chuck Hayes,644,244,11815,1047,2104,.498,0,14,.000,1047,2090,.501,.498,316,510,.620,1119,2124,3243,781,478,237,461,1485,2410,
272,Gordon Hayward,415,307,12632,1996,4557,.438,491,1356,.362,1505,3201,.470,.492,1448,1777,.815,308,1315,1623,1405,418,184,852,744,5931,
273,Brendan Haywood,816,549,18680,2110,3999,.528,0,4,.000,2110,3995,.528,.528,1318,2246,.587,2081,2794,4875,442,320,1109,851,2043,5538,
274,Gerald Henderson,436,292,11566,1909,4329,.441,171,538,.318,1738,3791,.458,.461,1057,1336,.791,268,1176,1444,866,296,161,545,755,5046,
275,Xavier Henry,185,23,2905,368,907,.406,41,126,.325,327,781,.419,.428,273,430,.635,81,270,351,120,100,23,139,264,1050,
276,John Henson,242,44,4611,822,1524,.539,0,4,.000,822,1520,.541,.539,269,501,.537,472,798,1270,244,99,376,296,520,1913,
277,Mario Hezonja,49,0,746,96,223,.430,37,102,.363,59,121,.488,.513,34,36,.944,19,71,90,54,12,8,57,67,263,
278,Roy Hibbert,587,546,15144,2492,5380,.463,6,24,.250,2486,5356,.464,.464,1273,1691,.753,1432,2474,3906,843,220,1073,989,1884,6263,
279,J.J. Hickson,519,307,11794,2024,4010,.505,0,20,.000,2024,3990,.507,.505,964,1549,.622,1156,2438,3594,442,269,307,765,1021,5012,
280,Nene,774,608,22145,3618,6658,.543,4,37,.108,3614,6621,.546,.544,2275,3409,.667,1476,3628,5104,1524,912,641,1524,2484,9515,
281,George Hill,522,297,14907,2090,4632,.451,611,1620,.377,1479,3012,.491,.517,1123,1399,.803,286,1351,1637,1690,484,158,671,1120,5914,
282,Darrun Hilliard,22,0,204,31,72,.431,9,25,.360,22,47,.468,.493,13,19,.684,4,16,20,14,4,0,10,17,84,
283,Jordan Hill,378,119,7210,1270,2549,.498,3,22,.136,1267,2527,.501,.499,489,704,.695,835,1425,2260,299,144,259,399,825,3032,
284,Solomon Hill,140,79,2943,304,767,.396,80,259,.309,224,508,.441,.449,184,220,.836,98,323,421,220,85,28,141,225,872,
285,Kirk Hinrich,868,665,26939,3501,8511,.411,1171,3116,.376,2330,5395,.432,.480,1416,1770,.800,309,2255,2564,4231,970,242,1614,2486,9589,
286,Jrue Holiday,418,361,13433,2291,5226,.438,435,1171,.371,1856,4055,.458,.480,740,935,.791,352,1120,1472,2521,597,149,1095,967,5757,
287,Justin Holiday,94,5,1062,131,356,.368,49,170,.288,82,186,.441,.437,48,63,.762,16,98,114,74,56,22,51,82,359,
288,Rondae Hollis-Jefferson,19,14,419,39,81,.481,1,5,.200,38,76,.500,.488,20,30,.667,32,84,116,27,27,8,21,42,99,
289,Ryan Hollins,500,67,5879,659,1134,.581,0,1,.000,659,1133,.582,.581,525,803,.654,431,655,1086,148,90,260,370,1007,1843,
290,Richaun Holmes,37,1,525,92,167,.551,6,33,.182,86,134,.642,.569,37,56,.661,43,50,93,22,12,31,21,64,227,
291,Rodney Hood,100,71,2636,416,991,.420,161,444,.363,255,547,.466,.501,185,221,.837,30,251,281,214,72,23,127,265,1178,
292,Scotty Hopson,2,0,7,0,4,.000,0,2,.000,0,2,.000,.000,1,2,.500,0,0,0,1,1,0,0,0,1,
293,Al Horford,551,547,18447,3372,6282,.537,76,227,.335,3296,6055,.544,.543,1058,1429,.740,1336,3590,4926,1496,458,657,880,1345,7878,
294,Dwight Howard,853,852,30232,5465,9411,.581,5,51,.098,5460,9360,.583,.581,4380,7671,.571,3015,7827,10842,1289,843,1776,2607,2805,15315,
295,Josh Howard,507,403,15350,2759,6161,.448,342,1029,.332,2417,5132,.471,.476,1410,1830,.770,846,2040,2886,817,530,276,723,1297,7270,
296,Lester Hudson,57,0,594,95,253,.375,28,101,.277,67,152,.441,.431,50,62,.806,16,61,77,71,32,8,56,52,268,
297,Marcelo Huertas,29,0,331,32,82,.390,8,27,.296,24,55,.436,.439,6,6,1.000,10,27,37,71,13,2,33,34,78,
298,Robbie Hummel,98,9,1397,146,349,.418,48,140,.343,98,209,.469,.487,39,45,.867,66,200,266,50,32,11,28,143,379,
299,Kris Humphries,719,196,13174,1934,4135,.468,25,93,.269,1909,4042,.472,.471,1037,1491,.696,1296,2709,4005,507,298,424,645,1335,4930,
300,R.J. Hunter,24,0,247,25,74,.338,12,49,.245,13,25,.520,.419,5,6,.833,2,29,31,9,12,4,7,29,67,
301,Serge Ibaka,499,388,14326,2427,4602,.527,162,437,.371,2265,4165,.544,.545,725,973,.745,1227,2472,3699,289,205,1267,642,1423,5741,
302,Andre Iguodala,886,759,31497,4294,9289,.462,838,2498,.335,3456,6791,.509,.507,2610,3648,.715,884,3900,4784,4094,1459,422,1917,1699,12036,
303,Ersan Ilyasova,505,309,12274,2064,4643,.445,506,1372,.369,1558,3271,.476,.499,799,1037,.770,956,2065,3021,560,361,198,501,1279,5433,
304,Joe Ingles,130,32,2404,222,533,.417,117,325,.360,105,208,.505,.526,38,50,.760,33,224,257,237,102,13,135,188,599,
305,Damien Inglis,8,0,42,2,8,.250,1,5,.200,1,3,.333,.313,3,4,.750,1,8,9,2,2,0,4,5,8,
306,Kyrie Irving,282,282,9607,2137,4705,.454,495,1296,.382,1642,3409,.482,.507,1099,1274,.863,209,774,983,1563,389,89,778,611,5868,
307,Jarrett Jack,803,343,22559,3183,7227,.440,595,1722,.346,2588,5505,.470,.482,1916,2239,.856,255,2041,2296,3599,646,103,1605,1481,8877,
308,Darnell Jackson,138,4,1039,123,274,.449,4,17,.235,119,257,.463,.456,58,90,.644,90,113,203,26,24,11,50,159,308,
309,Reggie Jackson,325,129,7681,1411,3247,.435,272,868,.313,1139,2379,.479,.476,597,704,.848,174,865,1039,1316,243,36,586,541,3691,
310,Bernard James,92,13,761,76,153,.497,0,3,.000,76,150,.507,.497,51,75,.680,85,127,212,13,17,61,34,105,203,
311,Damion James,39,17,623,61,147,.415,0,6,.000,61,141,.433,.415,28,42,.667,25,106,131,26,23,20,38,56,150,
312,LeBron James,962,961,37599,9434,19004,.496,1310,3866,.339,8124,15138,.537,.531,6010,8083,.744,1141,5725,6866,6634,1623,760,3224,1797,26188,
313,Mike James,595,286,14364,2139,5132,.417,687,1813,.379,1452,3319,.437,.484,898,1120,.802,212,1112,1324,2075,458,38,895,1201,5863,
314,Al Jefferson,785,648,24266,5677,11382,.499,8,62,.129,5669,11320,.501,.499,1870,2643,.708,1915,5169,7084,1220,577,1033,1137,2085,13232,
315,Cory Jefferson,58,1,581,84,189,.444,2,16,.125,82,173,.474,.450,35,60,.583,53,108,161,16,10,22,20,69,205,
316,Othyus Jeffers,37,2,442,46,100,.460,1,6,.167,45,94,.479,.465,46,69,.667,34,61,95,22,21,0,21,45,139,
317,Richard Jefferson,1056,794,32078,4937,10629,.464,957,2517,.380,3980,8112,.491,.510,3454,4495,.768,882,3562,4444,2301,747,334,1696,2434,14285,
318,Charles Jenkins,110,29,1334,179,412,.434,4,22,.182,175,390,.449,.439,46,61,.754,16,84,100,214,48,8,81,107,408,
319,John Jenkins,119,6,1550,225,505,.446,81,227,.357,144,278,.518,.526,87,102,.853,26,151,177,89,26,11,70,74,618,
320,Brandon Jennings,435,410,14385,2472,6330,.391,799,2285,.350,1673,4045,.414,.454,1233,1541,.800,284,1098,1382,2612,585,85,1022,836,6976,
321,Jonas Jerebko,386,88,7306,984,2137,.460,205,581,.353,779,1556,.501,.508,428,561,.763,550,1059,1609,294,239,90,310,796,2601,
322,Grant Jerrett,8,0,51,7,26,.269,1,15,.067,6,11,.545,.288,1,1,1.000,2,7,9,3,2,2,3,11,16,
323,Amir Johnson,638,357,14425,2046,3569,.573,57,175,.326,1989,3394,.586,.581,704,1038,.678,1375,2297,3672,709,396,692,723,2005,4853,
324,Chris Johnson,71,1,597,77,137,.562,0,0,,77,137,.562,.562,51,73,.699,47,85,132,13,16,46,38,103,205,
325,Chris Johnson,120,3,1929,201,509,.395,95,301,.316,106,208,.510,.488,77,93,.828,62,185,247,83,81,21,66,173,574,
326,Darius Johnson-Odom,7,0,21,0,11,.000,0,4,.000,0,7,.000,.000,0,2,.000,1,5,6,2,1,0,2,3,0,
327,Ivan Johnson,125,5,1969,326,631,.517,3,19,.158,323,612,.528,.519,153,231,.662,141,351,492,78,99,32,140,247,808,
328,James Johnson,381,127,6958,1013,2114,.479,90,335,.269,923,1779,.519,.500,390,561,.695,337,882,1219,563,284,365,478,809,2506,
329,Joe Johnson,1116,1046,40312,7258,16454,.441,1794,4836,.371,5464,11618,.470,.496,2639,3295,.801,1004,3555,4559,4675,994,233,2281,2040,18949,
330,Nick Johnson,28,0,262,26,75,.347,5,21,.238,21,54,.389,.380,17,25,.680,13,26,39,11,7,3,19,34,74,
331,Orlando Johnson,98,0,1058,113,311,.363,46,147,.313,67,164,.409,.437,47,64,.734,32,142,174,67,19,14,45,82,319,
332,Stanley Johnson,54,5,1295,188,482,.390,51,162,.315,137,320,.428,.443,63,80,.788,44,183,227,89,39,8,83,138,490,
333,Trey Johnson,23,0,169,20,52,.385,1,3,.333,19,49,.388,.394,18,19,.947,5,15,20,15,2,1,11,26,59,
334,Tyler Johnson,68,7,1466,188,409,.460,45,118,.381,143,291,.491,.515,83,111,.748,42,148,190,121,57,23,77,108,504,
335,Wesley Johnson,402,275,10004,1288,3136,.411,467,1349,.346,821,1787,.459,.485,287,385,.745,257,1098,1355,520,316,279,411,813,3330,
336,Nikola Jokic,52,27,1039,192,365,.526,16,41,.390,176,324,.543,.548,93,118,.788,114,194,308,97,51,28,64,125,493,
337,Dahntay Jones,622,157,9745,1194,2717,.439,106,321,.330,1088,2396,.454,.459,837,1114,.751,250,825,1075,526,260,142,506,1199,3331,
338,DeQuan Jones,63,17,803,95,218,.436,9,35,.257,86,183,.470,.456,34,51,.667,17,88,105,16,19,22,30,55,233,
339,James Jones,648,91,10591,1140,2869,.397,731,1843,.397,409,1026,.399,.525,513,607,.845,221,1005,1226,351,217,204,218,887,3524,
340,Kevin Jones,32,0,334,43,107,.402,0,0,,43,107,.402,.402,9,15,.600,38,40,78,10,9,5,8,25,95,
341,Perry Jones,143,21,1675,195,464,.420,36,123,.293,159,341,.466,.459,62,94,.660,46,206,252,54,36,33,60,135,488,
342,Solomon Jones,281,12,3092,301,645,.467,1,9,.111,300,636,.472,.467,236,329,.717,257,397,654,99,58,154,161,554,839,
343,Terrence Jones,173,106,4246,747,1460,.512,74,236,.314,673,1224,.550,.537,263,418,.629,327,690,1017,179,105,214,168,319,1831,
344,Tyus Jones,10,0,110,12,36,.333,2,5,.400,10,31,.323,.361,4,6,.667,3,15,18,19,4,1,8,6,30,
345,DeAndre Jordan,566,454,15183,1941,2906,.668,1,8,.125,1940,2898,.669,.668,878,2098,.418,1730,3630,5360,310,333,1011,684,1533,4761,
346,Jerome Jordan,65,0,491,67,127,.528,0,0,,67,127,.528,.528,46,54,.852,66,66,132,17,9,21,24,73,180,
347,Cory Joseph,256,43,4374,576,1226,.470,53,180,.294,523,1046,.500,.491,312,409,.763,117,395,512,549,144,52,212,316,1517,
348,Kris Joseph,10,0,54,2,14,.143,0,3,.000,2,11,.182,.143,5,8,.625,1,6,7,1,3,0,2,3,9,
349,Chris Kaman,727,538,19594,3422,7008,.488,0,21,.000,3422,6987,.490,.488,1340,1805,.742,1483,4084,5567,915,321,930,1541,1959,8184,
350,Frank Kaminsky,52,0,1115,140,349,.401,42,129,.326,98,220,.445,.461,75,102,.735,43,166,209,71,21,30,43,82,397,
351,Enes Kanter,344,113,7319,1477,2847,.519,21,57,.368,1456,2790,.522,.522,617,814,.758,896,1360,2256,195,121,150,513,726,3592,
352,Jason Kapono,509,87,9068,1336,3026,.442,457,1054,.434,879,1972,.446,.517,269,322,.835,165,679,844,417,180,25,327,777,3398,
353,Sergey Karasev,79,17,855,75,193,.389,22,84,.262,53,109,.486,.446,44,54,.815,25,75,100,60,27,2,42,73,216,
354,Sasha Kaun,10,0,42,3,5,.600,0,0,,3,5,.600,.600,3,6,.500,8,3,11,2,2,2,6,7,9,
355,Ryan Kelly,130,59,2796,296,770,.384,98,305,.321,198,465,.426,.448,215,269,.799,66,373,439,201,70,77,96,283,905,
356,D.J. Kennedy,2,0,59,5,12,.417,2,4,.500,3,8,.375,.500,0,2,.000,1,6,7,3,2,0,3,7,12,
357,Michael Kidd-Gilchrist,202,198,5319,705,1509,.467,6,25,.240,699,1484,.471,.469,423,614,.689,361,879,1240,255,130,150,232,433,1839,
358,Sean Kilpatrick,12,0,154,15,41,.366,8,30,.267,7,11,.636,.463,11,12,.917,3,9,12,7,5,0,6,10,49,
359,Alex Kirk,5,0,14,1,4,.250,0,0,,1,4,.250,.250,2,2,1.000,1,0,1,1,0,0,0,1,4,
360,Linas Kleiza,409,65,8185,1268,2912,.435,387,1154,.335,881,1758,.501,.502,638,836,.763,388,1082,1470,321,159,73,409,886,3561,
361,Brandon Knight,318,306,10452,1821,4355,.418,547,1523,.359,1274,2832,.450,.481,845,1052,.803,188,926,1114,1451,320,58,898,670,5034,
362,Kyle Korver,937,369,24759,3224,7300,.442,1832,4265,.430,1392,3035,.459,.567,1093,1243,.879,299,2633,2932,1720,674,320,1034,2047,9373,
363,Kosta Koufos,476,148,7502,1157,2188,.529,0,3,.000,1157,2185,.530,.529,319,522,.611,827,1444,2271,175,183,386,329,959,2633,
364,Viacheslav Kravtsov,45,0,283,41,61,.672,0,0,,41,61,.672,.672,15,45,.333,33,29,62,10,5,10,20,39,97,
365,Ognjen Kuzmic,37,0,164,13,25,.520,0,0,,13,25,.520,.520,9,15,.600,17,21,38,8,5,5,15,30,35,
366,Doron Lamb,100,0,1272,123,323,.381,50,127,.394,73,196,.372,.458,49,70,.700,16,79,95,75,24,1,53,106,345,
367,Jeremy Lamb,191,8,3211,570,1314,.434,177,521,.340,393,793,.496,.501,164,197,.832,74,421,495,220,106,52,128,275,1481,
368,Carl Landry,491,83,11118,1987,3720,.534,4,20,.200,1983,3700,.536,.535,1308,1664,.786,957,1468,2425,329,209,199,591,1160,5286,
369,Marcus Landry,18,0,111,16,43,.372,9,28,.321,7,15,.467,.477,3,5,.600,5,14,19,0,1,2,6,14,44,
370,Shane Larkin,174,27,3384,372,870,.428,73,227,.322,299,643,.465,.470,118,154,.766,52,280,332,490,178,20,210,275,935,
371,Joffrey Lauvergne,56,16,831,135,291,.464,15,51,.294,120,240,.500,.490,48,62,.774,76,165,241,46,16,18,51,108,333,
372,Zach LaVine,131,47,3217,547,1278,.428,114,332,.343,433,946,.458,.473,261,317,.823,48,325,373,449,89,19,293,290,1469,
373,Gani Lawal,1,0,2,0,0,,0,0,,0,0,,,0,0,,0,0,0,0,0,0,0,1,0,
374,Ty Lawson,464,319,14069,2227,4821,.462,434,1185,.366,1793,3636,.493,.507,1335,1739,.768,301,991,1292,2919,548,45,1011,761,6223,
375,Ricky Ledo,28,0,277,38,113,.336,13,35,.371,25,78,.321,.394,20,26,.769,16,22,38,21,7,1,28,23,109,
376,Courtney Lee,572,332,15551,2106,4677,.450,587,1531,.383,1519,3146,.483,.513,725,858,.845,255,1216,1471,885,577,151,561,969,5524,
377,David Lee,725,494,22383,4248,8003,.531,1,29,.034,4247,7974,.533,.531,1946,2511,.775,1941,4763,6704,1671,584,274,1344,1982,10443,
378,Malcolm Lee,36,12,534,52,136,.382,10,34,.294,42,102,.412,.419,26,37,.703,24,41,65,51,20,10,27,52,140,
379,Alex Len,162,67,2873,348,728,.478,2,7,.286,346,721,.480,.479,173,246,.703,280,590,870,83,64,169,172,414,871,
380,Kawhi Leonard,303,276,8955,1565,3132,.500,334,848,.394,1231,2284,.539,.553,664,808,.822,392,1495,1887,583,535,200,357,531,4128,
381,Meyers Leonard,211,26,3492,478,973,.491,115,314,.366,363,659,.551,.550,146,179,.816,195,659,854,158,35,71,165,500,1217,
382,Jon Leuer,229,40,3077,513,1069,.480,66,172,.384,447,897,.498,.511,140,200,.700,187,574,761,153,79,57,139,322,1232,
383,DeAndre Liggins,57,1,406,34,73,.466,7,23,.304,27,50,.540,.514,18,37,.486,20,49,69,20,24,3,24,39,93,
384,Damian Lillard,293,293,10725,2083,4878,.427,737,2009,.367,1346,2869,.469,.503,1216,1412,.861,158,970,1128,1839,281,77,815,644,6119,
385,Jeremy Lin,341,181,9171,1370,3151,.435,308,892,.345,1062,2259,.470,.484,964,1206,.799,152,782,934,1552,405,137,816,782,4012,
386,Shaun Livingston,593,180,13173,1626,3419,.476,12,63,.190,1614,3356,.481,.477,756,948,.797,374,1138,1512,1993,457,227,843,1132,4020,
387,Kevon Looney,2,0,8,2,3,.667,1,1,1.000,1,2,.500,.833,0,0,,0,2,2,0,0,0,0,1,5,
388,Brook Lopez,468,433,15257,3328,6525,.510,1,24,.042,3327,6501,.512,.510,1837,2323,.791,1317,2156,3473,633,273,822,920,1325,8494,
389,Robin Lopez,520,372,11267,1736,3265,.532,0,3,.000,1736,3262,.532,.532,843,1105,.763,1226,1474,2700,312,140,626,512,1105,4315,
390,Kevin Love,490,408,16103,3001,6738,.445,690,1895,.364,2311,4843,.477,.497,2324,2858,.813,1596,4115,5711,1187,340,242,969,1056,9016,
391,Kyle Lowry,628,392,18876,2679,6405,.418,877,2476,.354,1802,3929,.459,.487,2039,2547,.801,532,1980,2512,3537,850,165,1337,1701,8274,
392,John Lucas III,237,8,2916,453,1181,.384,163,473,.345,290,708,.410,.453,76,99,.768,57,180,237,361,86,2,128,195,1145,
393,Kalin Lucas,1,0,6,0,1,.000,0,0,,0,1,.000,.000,0,0,,0,0,0,0,1,0,0,1,0,
394,Trey Lyles,50,29,857,91,217,.419,20,49,.408,71,168,.423,.465,29,46,.630,43,151,194,35,12,11,39,72,231,
395,Scott Machado,6,0,21,3,6,.500,0,1,.000,3,5,.600,.500,2,2,1.000,0,1,1,6,2,0,8,0,8,
396,Vernon Macklin,23,0,135,19,35,.543,0,0,,19,35,.543,.543,8,14,.571,14,20,34,5,4,4,3,9,46,
397,Shelvin Mack,247,14,3697,512,1234,.415,136,429,.317,376,805,.467,.470,149,192,.776,46,347,393,663,131,6,234,228,1309,
398,Ian Mahinmi,411,65,6593,728,1376,.529,0,6,.000,728,1370,.531,.529,502,842,.596,583,1116,1699,166,204,285,353,1035,1958,
399,Devyn Marble,24,7,228,15,50,.300,4,24,.167,11,26,.423,.340,5,17,.294,6,28,34,17,10,2,10,16,39,
400,Boban Marjanovic,34,1,295,67,110,.609,0,0,,67,110,.609,.609,60,81,.741,46,77,123,12,10,15,21,39,194,
401,Kendall Marshall,144,56,2883,292,732,.399,118,320,.369,174,412,.422,.480,39,65,.600,22,216,238,751,98,8,273,162,741,
402,Cartier Martin,243,15,3351,430,1098,.392,218,586,.372,212,512,.414,.491,151,207,.729,88,375,463,121,97,27,128,317,1229,
403,Jarell Martin,2,0,9,1,5,.200,0,0,,1,5,.200,.200,0,0,,0,0,0,0,0,0,0,2,2,
404,Kevin Martin,694,503,21255,3812,8701,.438,1128,2932,.385,2684,5769,.465,.503,3525,4051,.870,396,1843,2239,1338,633,76,1180,1338,12277,
405,Wesley Matthews,492,432,15907,2373,5428,.437,1005,2594,.387,1368,2834,.483,.530,1161,1404,.827,300,1224,1524,1007,555,94,654,1086,6912,
406,Jason Maxiell,618,188,11379,1398,2823,.495,0,5,.000,1398,2818,.496,.495,685,1214,.564,1048,1528,2576,266,230,490,487,1197,3481,
407,Eric Maynor,267,2,3896,440,1122,.392,111,317,.350,329,805,.409,.442,150,208,.721,67,281,348,760,111,20,281,296,1141,
408,O.J. Mayo,536,314,16634,2788,6493,.429,837,2246,.373,1951,4247,.459,.494,1103,1344,.821,282,1396,1678,1585,545,137,1105,1197,7516,
409,Luc Mbah a Moute,517,338,12163,1280,2890,.443,97,317,.306,1183,2573,.460,.460,671,1014,.662,878,1510,2388,481,437,198,519,978,3328,
410,Didier Ilunga-Mbenga,234,4,1566,180,383,.470,0,2,.000,180,381,.472,.470,54,89,.607,129,222,351,41,37,141,87,286,414,
411,James Michael McAdoo,40,0,284,46,84,.548,0,0,,46,84,.548,.548,27,52,.519,29,40,69,11,12,14,15,39,119,
412,Ray McCallum,138,43,2573,345,832,.415,61,185,.330,284,647,.439,.451,97,135,.719,76,214,290,339,71,24,135,175,848,
413,C.J. McCollum,152,55,3269,653,1493,.437,210,538,.390,443,955,.464,.508,184,245,.751,52,274,326,311,121,23,205,257,1700,
414,T.J. McConnell,53,17,1109,144,307,.469,23,67,.343,121,240,.504,.507,17,28,.607,32,161,193,252,69,8,106,78,328,
415,Chris McCullough,2,0,25,3,8,.375,1,3,.333,2,5,.400,.438,0,0,,1,2,3,0,1,1,3,6,7,
416,K.J. McDaniels,78,15,1414,180,460,.391,45,157,.287,135,303,.446,.440,106,142,.746,69,144,213,73,47,74,109,138,511,
417,Doug McDermott,87,4,1463,207,484,.428,83,206,.403,124,278,.446,.513,33,42,.786,28,134,162,38,12,5,57,107,530,
418,Mitch McGary,46,2,541,94,179,.525,0,5,.000,94,174,.540,.525,29,48,.604,57,121,178,16,16,18,37,80,217,
419,JaVale McGee,414,160,7961,1424,2624,.543,1,6,.167,1423,2618,.544,.543,543,931,.583,831,1406,2237,138,163,711,438,953,3392,
420,Dominic McGuire,342,84,5348,388,927,.419,3,16,.188,385,911,.423,.420,160,243,.658,344,825,1169,422,154,184,242,501,939,
421,Ben McLemore,213,178,5888,755,1814,.416,280,809,.346,475,1005,.473,.493,305,385,.792,107,471,578,281,163,44,304,519,2095,
422,Jerel McNeal,6,0,36,3,11,.273,1,2,.500,2,9,.222,.318,2,2,1.000,0,3,3,2,3,1,5,5,9,
423,Jordan McRae,6,0,68,9,21,.429,2,9,.222,7,12,.583,.476,9,11,.818,1,5,6,7,2,0,5,4,29,
424,Josh McRoberts,392,164,7657,843,1777,.474,174,519,.335,669,1258,.532,.523,294,415,.708,438,1137,1575,811,207,188,349,757,2154,
425,Jodie Meeks,417,194,10123,1378,3266,.422,635,1704,.373,743,1562,.476,.519,712,808,.881,127,775,902,457,349,27,335,531,4103,
426,Salah Mejri,14,3,150,20,30,.667,0,0,,20,30,.667,.667,13,19,.684,14,27,41,2,2,8,9,18,53,
427,Gal Mekel,35,1,335,33,106,.311,5,23,.217,28,83,.337,.335,8,12,.667,5,23,28,76,6,1,33,32,79,
428,Fab Melo,6,0,36,3,6,.500,0,0,,3,6,.500,.500,1,4,.250,0,3,3,0,2,2,1,7,7,
429,Pops Mensah-Bonsu,61,0,509,64,156,.410,0,2,.000,64,154,.416,.410,53,90,.589,83,97,180,11,14,14,40,82,181,
430,Jordan Mickey,3,0,6,2,3,.667,0,0,,2,3,.667,.667,3,3,1.000,2,1,3,1,0,1,0,1,7,
431,Khris Middleton,241,175,7225,1169,2625,.445,346,857,.404,823,1768,.465,.511,464,537,.864,140,766,906,587,286,44,358,618,3148,
432,C.J. Miles,623,270,12880,2180,5262,.414,799,2295,.348,1381,2967,.465,.490,851,1067,.798,295,1203,1498,752,475,182,598,1382,6010,
433,Andre Miller,1291,935,40087,6012,13056,.460,192,884,.217,5820,12172,.478,.468,4006,4962,.807,1367,3401,4768,8495,1539,227,3109,2868,16222,
434,Darius Miller,102,10,1460,118,281,.420,47,134,.351,71,147,.483,.504,37,44,.841,17,114,131,89,42,21,46,185,320,
435,Mike Miller,1003,569,27598,4001,8709,.459,1577,3878,.407,2424,4831,.502,.550,1349,1755,.769,630,3700,4330,2638,568,228,1546,2025,10928,
436,Quincy Miller,69,16,934,107,306,.350,33,113,.292,74,193,.383,.404,48,68,.706,41,128,169,37,30,37,54,82,295,
437,Elijah Millsap,67,5,1097,92,277,.332,29,102,.284,63,175,.360,.384,71,104,.683,34,151,185,77,63,19,76,157,284,
438,Paul Millsap,741,465,21442,3894,7768,.501,231,686,.337,3663,7082,.517,.516,2198,3003,.732,1733,3718,5451,1581,963,742,1300,2372,10217,
439,Patty Mills,333,9,5139,931,2113,.441,399,1019,.392,532,1094,.486,.535,198,238,.832,104,376,480,587,203,21,275,373,2459,
440,Nikola Mirotic,126,34,2710,403,1013,.398,173,522,.331,230,491,.468,.483,320,402,.796,106,556,662,158,92,83,156,262,1299,
441,Tony Mitchell,21,0,79,5,12,.417,1,1,1.000,4,11,.364,.458,11,19,.579,15,11,26,2,6,3,4,9,22,
442,Tony Mitchell,3,0,10,3,5,.600,0,1,.000,3,4,.750,.600,0,0,,1,0,1,1,1,0,0,0,6,
443,Nazr Mohammed,1000,354,15872,2399,4934,.486,0,8,.000,2399,4926,.487,.486,1021,1597,.639,1807,2897,4704,375,432,639,916,2152,5819,
444,Greg Monroe,429,384,13370,2498,4919,.508,0,7,.000,2498,4912,.509,.508,1271,1816,.700,1365,2608,3973,968,497,272,880,1027,6267,
445,Luis Montero,7,0,23,5,13,.385,1,5,.200,4,8,.500,.423,2,2,1.000,0,2,2,1,0,0,2,1,13,
446,E'Twaun Moore,288,32,4769,641,1523,.421,179,499,.359,462,1024,.451,.480,134,182,.736,104,354,458,435,166,55,225,366,1595,
447,Eric Moreland,8,0,26,3,4,.750,0,0,,3,4,.750,.750,0,2,.000,1,6,7,0,0,4,0,3,6,
448,Darius Morris,132,17,1464,166,432,.384,47,146,.322,119,286,.416,.439,51,81,.630,40,86,126,189,45,2,112,127,430,
449,Markieff Morris,345,145,8715,1534,3465,.443,201,621,.324,1333,2844,.469,.472,671,884,.759,492,1368,1860,596,320,213,581,969,3940,
450,Marcus Morris,310,112,7412,1122,2622,.428,355,1004,.354,767,1618,.474,.496,410,588,.697,309,957,1266,414,229,71,339,633,3009,
451,Anthony Morrow,494,134,11316,1814,4021,.451,743,1739,.427,1071,2282,.469,.544,562,636,.884,295,877,1172,461,290,71,367,835,4933,
452,Donatas Motiejunas,191,80,3715,612,1271,.482,101,317,.319,511,954,.536,.521,199,327,.609,240,529,769,209,89,67,234,433,1524,
453,Arnett Moultrie,59,2,729,94,172,.547,0,0,,94,172,.547,.547,22,33,.667,87,93,180,12,25,14,26,65,210,
454,Timofey Mozgov,342,191,6251,938,1764,.532,7,39,.179,931,1725,.540,.534,491,673,.730,590,1140,1730,186,111,317,395,772,2374,
455,Emmanuel Mudiay,40,38,1208,170,500,.340,31,114,.272,139,386,.360,.371,85,138,.616,19,110,129,235,43,23,141,79,456,
456,Shabazz Muhammad,129,13,2249,442,938,.471,50,159,.314,392,779,.503,.498,246,333,.739,143,232,375,78,40,12,98,138,1180,
457,Byron Mullens,189,66,3446,557,1366,.408,111,348,.319,446,1018,.438,.448,173,245,.706,200,590,790,153,74,98,187,335,1398,
458,Erik Murphy,24,0,62,3,13,.231,0,3,.000,3,10,.300,.231,0,0,,2,6,8,2,0,4,2,7,6,
459,Kevin Murphy,17,0,52,7,28,.250,1,5,.200,6,23,.261,.268,0,0,,0,4,4,2,1,0,3,4,15,
460,Toure' Murry,56,0,391,58,134,.433,5,12,.417,53,122,.434,.451,25,41,.610,14,31,45,50,20,1,38,48,146,
461,Mike Muscala,100,8,1162,172,339,.507,19,58,.328,153,281,.544,.535,59,68,.868,94,164,258,57,28,47,55,136,422,
462,Larry Nance Jr.,40,22,811,105,194,.541,1,3,.333,104,191,.545,.544,21,30,.700,60,138,198,26,33,10,27,78,232,
463,Shabazz Napier,95,10,1545,147,402,.366,71,203,.350,76,199,.382,.454,73,94,.777,25,135,160,219,63,5,123,113,438,
464,Hamady N'Diaye,33,0,157,7,15,.467,0,0,,7,15,.467,.467,6,13,.462,7,18,25,3,2,9,6,33,20,
465,Gary Neal,350,31,7489,1275,3014,.423,460,1201,.383,815,1813,.450,.499,456,537,.849,81,678,759,572,145,10,365,524,3466,
466,Nemanja Nedovic,24,0,142,8,39,.205,3,18,.167,5,21,.238,.244,7,8,.875,3,12,15,13,0,1,13,13,26,
467,Jameer Nelson,752,600,21474,3427,7843,.437,1006,2737,.368,2421,5106,.474,.501,1146,1408,.814,385,1913,2298,3944,691,56,1636,1916,9006,
468,Raul Neto,51,50,1043,123,291,.423,44,111,.396,79,180,.439,.498,26,37,.703,13,65,78,126,44,2,71,89,316,
469,Andrew Nicholson,227,36,3465,604,1290,.468,66,201,.328,538,1089,.494,.494,162,208,.779,163,562,725,103,54,80,182,380,1436,
470,Joakim Noah,572,465,16848,2030,4141,.490,0,14,.000,2030,4127,.492,.490,1265,1780,.711,1910,3477,5387,1704,481,803,1015,1637,5325,
471,Nerlens Noel,121,113,3659,506,1036,.488,0,0,,506,1036,.488,.488,227,379,.599,285,701,986,201,210,216,258,328,1239,
472,Lucas Nogueira,24,0,157,22,37,.595,1,2,.500,21,35,.600,.608,8,13,.615,11,25,36,4,11,5,7,25,53,
473,Steve Novak,455,6,5613,745,1701,.438,570,1322,.431,175,379,.462,.606,99,113,.876,68,518,586,132,91,38,80,368,2159,
474,Dirk Nowitzki,1314,1283,46403,10204,21506,.474,1655,4325,.383,8549,17181,.498,.513,6916,7866,.879,1401,8975,10376,3363,1108,1162,2341,3200,28979,
475,James Nunnally,13,0,165,15,46,.326,8,25,.320,7,21,.333,.413,6,9,.667,1,18,19,8,6,2,7,11,44,
476,Jusuf Nurkic,79,27,1337,211,496,.425,0,4,.000,211,492,.429,.425,114,179,.637,153,315,468,63,59,84,104,248,536,
477,J.J. O'Brien,2,0,6,0,1,.000,0,0,,0,1,.000,.000,0,0,,0,1,1,0,1,0,0,1,0,
478,Johnny O'Bryant,81,18,1040,110,281,.391,1,1,1.000,109,280,.389,.393,34,60,.567,78,123,201,46,20,11,52,125,255,
479,Patrick O'Bryant,90,3,524,79,160,.494,0,3,.000,79,157,.503,.494,28,48,.583,32,95,127,25,18,40,42,126,186,
480,Greg Oden,105,66,2028,317,552,.574,0,0,,317,552,.574,.574,206,313,.658,256,400,656,51,40,130,138,374,840,
481,Tim Ohlbrecht,3,0,12,1,3,.333,0,0,,1,3,.333,.333,1,1,1.000,0,1,1,1,1,0,4,1,3,
482,Jahlil Okafor,47,42,1431,345,699,.494,0,3,.000,345,696,.496,.494,116,170,.682,113,234,347,58,21,56,110,120,806,
483,Victor Oladipo,200,143,6562,1115,2623,.425,223,662,.337,892,1961,.455,.468,633,785,.806,120,733,853,815,313,83,568,508,3086,
484,Kelly Olynyk,188,30,3919,691,1477,.468,170,456,.373,521,1021,.510,.525,259,350,.740,292,608,900,302,142,97,267,572,1811,
485,Jermaine O'Neal,1011,697,27364,5144,11025,.467,14,95,.147,5130,10930,.469,.467,3007,4208,.715,1991,5270,7261,1369,470,1820,1872,2896,13309,
486,Arinze Onuaku,11,1,98,13,19,.684,0,0,,13,19,.684,.684,4,10,.400,9,20,29,7,1,3,3,9,30,
487,Kyle O'Quinn,220,42,3133,487,980,.497,13,61,.213,474,919,.516,.504,161,224,.719,260,669,929,237,97,181,215,453,1148,
488,Daniel Orton,51,6,542,50,103,.485,0,1,.000,50,102,.490,.485,43,72,.597,48,78,126,24,18,28,29,81,143,
489,Kelly Oubre Jr.,42,9,505,58,142,.408,21,58,.362,37,84,.440,.482,24,35,.686,18,74,92,11,15,6,21,67,161,
490,Travis Outlaw,622,98,13026,1994,4713,.423,344,1021,.337,1650,3692,.447,.460,941,1265,.744,480,1494,1974,514,331,381,512,1035,5273,
491,Zaza Pachulia,865,367,18600,2158,4679,.461,0,23,.000,2158,4656,.463,.461,1882,2528,.744,1967,3169,5136,1072,624,305,1201,2250,6198,
492,Kostas Papanikolaou,69,7,1089,93,263,.354,41,138,.297,52,125,.416,.432,22,32,.688,47,111,158,101,42,18,76,95,249,
493,Jannero Pargo,499,18,7449,1228,3140,.391,400,1124,.356,828,2016,.411,.455,319,369,.864,112,589,701,986,250,28,560,648,3175,
494,Jabari Parker,72,68,2082,350,718,.487,4,23,.174,346,695,.498,.490,129,172,.750,122,232,354,107,68,26,99,129,833,
495,Tony Parker,1056,1043,33921,7012,14167,.495,462,1418,.326,6550,12749,.514,.511,3118,4139,.753,406,2646,3052,6214,957,84,2584,1824,17604,
496,Chandler Parsons,326,310,10860,1780,3775,.472,544,1445,.376,1236,2330,.530,.544,525,750,.700,320,1322,1642,974,333,125,536,684,4629,
497,Lamar Patterson,35,0,395,28,80,.350,12,49,.245,16,31,.516,.425,16,22,.727,4,46,50,39,9,2,23,45,84,
498,Patrick Patterson,385,65,9085,1281,2736,.468,281,772,.364,1000,1964,.509,.520,240,323,.743,597,1220,1817,467,229,211,304,715,3083,
499,Chris Paul,747,747,26890,4938,10447,.473,827,2262,.366,4111,8185,.502,.512,3284,3809,.862,516,2737,3253,7400,1744,77,1815,1854,13987,
500,Sasha Pavlovic,567,142,8888,1070,2651,.404,308,890,.346,762,1761,.433,.462,339,504,.673,188,812,1000,517,272,98,460,1026,2787,
501,Adreian Payne,65,24,1050,127,307,.414,9,32,.281,118,275,.429,.428,38,58,.655,58,171,229,46,28,17,65,137,301,
502,Cameron Payne,36,0,426,78,177,.441,31,75,.413,47,102,.461,.528,10,13,.769,6,56,62,68,26,5,21,48,197,
503,Elfrid Payton,130,110,3923,516,1213,.425,32,100,.320,484,1113,.435,.439,198,344,.576,154,368,522,812,204,32,319,304,1262,
504,Oleksiy Pecherov,111,5,1044,160,414,.386,45,155,.290,115,259,.444,.441,73,92,.793,88,178,266,20,21,22,59,119,438,
505,Nikola Pekovic,271,194,6744,1314,2537,.518,0,0,,1314,2537,.518,.518,777,1023,.760,803,1004,1807,199,140,151,414,632,3405,
506,Jeff Ayres,225,15,2229,277,498,.556,2,4,.500,275,494,.557,.558,110,143,.769,193,420,613,96,37,66,127,344,666,
507,Kendrick Perkins,754,563,16694,1677,3158,.531,0,14,.000,1677,3144,.533,.531,793,1330,.596,1286,3136,4422,785,251,894,1199,2087,4147,
508,Johan Petro,473,139,7262,976,2114,.462,2,13,.154,974,2101,.464,.462,248,366,.678,536,1300,1836,227,193,234,374,1158,2202,
509,Paul Pierce,1298,1262,45220,8589,19269,.446,2107,5703,.369,6482,13566,.478,.500,6887,8540,.806,1088,6340,7428,4677,1736,734,3494,3561,26172,
510,Mickael Pietrus,557,172,11950,1625,3821,.425,679,1910,.355,946,1911,.495,.514,700,1053,.665,440,1283,1723,445,371,230,576,1270,4629,
511,Dexter Pittman,50,6,347,49,109,.450,0,0,,49,109,.450,.450,18,33,.545,38,51,89,9,8,8,22,83,116,
512,Tibor Pleiss,12,0,82,11,25,.440,0,2,.000,11,23,.478,.440,2,2,1.000,6,9,15,2,1,2,8,19,24,
513,Mason Plumlee,206,121,4394,660,1145,.576,0,8,.000,660,1137,.580,.576,406,717,.566,416,816,1232,274,156,174,289,546,1726,
514,Miles Plumlee,199,109,3510,469,901,.521,0,0,,469,901,.521,.521,110,196,.561,355,691,1046,84,99,182,179,329,1048,
515,Quincy Pondexter,279,47,5042,528,1244,.424,202,553,.365,326,691,.472,.506,208,284,.732,184,383,567,230,103,46,154,416,1466,
516,Otto Porter,154,54,3079,414,919,.450,90,284,.317,324,635,.510,.499,130,174,.747,146,358,504,156,123,45,111,223,1048,
517,Bobby Portis,32,0,519,96,214,.449,7,25,.280,89,189,.471,.465,25,35,.714,54,93,147,18,15,13,31,53,224,
518,Kristaps Porzingis,54,54,1525,276,648,.426,61,175,.349,215,473,.455,.473,139,164,.848,111,304,415,65,41,105,94,153,752,
519,Dwight Powell,81,0,1087,157,319,.492,5,23,.217,152,296,.514,.500,120,160,.750,87,203,290,45,37,27,47,141,439,
520,Josh Powell,316,28,3966,498,1136,.438,7,20,.350,491,1116,.440,.441,223,300,.743,331,601,932,161,49,68,254,491,1226,
521,Norman Powell,24,4,156,14,51,.275,1,12,.083,13,39,.333,.284,3,5,.600,6,20,26,7,10,1,7,19,32,
522,Phil Pressey,139,11,1902,163,482,.338,48,184,.261,115,298,.386,.388,71,112,.634,33,175,208,404,109,12,147,165,445,
523,A.J. Price,261,25,3929,549,1444,.380,218,690,.316,331,754,.439,.456,207,279,.742,68,309,377,567,125,9,229,237,1523,
524,Ronnie Price,502,56,6452,665,1777,.374,205,679,.302,460,1098,.419,.432,278,374,.743,158,428,586,854,375,47,429,824,1813,
525,Pablo Prigioni,244,49,4190,305,706,.432,187,483,.387,118,223,.529,.564,70,80,.875,129,322,451,700,248,5,235,392,867,
526,Tayshaun Prince,993,900,31245,4563,10026,.455,568,1541,.369,3995,8485,.471,.483,1532,2027,.756,1116,3175,4291,2385,561,498,1057,1236,11226,
527,Miroslav Raduljica,53,2,488,71,134,.530,0,0,,71,134,.530,.530,47,57,.825,56,57,113,23,8,13,30,92,189,
528,Julius Randle,55,33,1490,234,562,.416,7,23,.304,227,539,.421,.423,126,182,.692,118,420,538,91,34,22,102,166,601,
529,Anthony Randolph,252,43,3841,677,1494,.453,20,83,.241,657,1411,.466,.460,415,561,.740,335,743,1078,187,150,224,298,456,1789,
530,Shavlik Randolph,146,7,1202,129,287,.449,1,6,.167,128,281,.456,.451,81,149,.544,151,212,363,36,44,38,59,193,340,
531,Zach Randolph,964,800,30694,6498,13725,.473,123,472,.261,6375,13253,.481,.478,3214,4214,.763,2956,6112,9068,1734,742,277,2041,2326,16333,
532,J.J. Redick,586,215,14256,2210,4964,.445,1000,2448,.408,1210,2516,.481,.546,1199,1354,.886,113,986,1099,1131,252,36,601,846,6619,
533,Willie Reed,26,0,267,47,80,.588,0,0,,47,80,.588,.588,16,32,.500,26,44,70,5,3,14,13,34,110,
534,Glen Rice, Jr.,16,1,152,14,52,.269,6,24,.250,8,28,.286,.327,9,13,.692,6,18,24,9,6,1,11,18,43,
535,Josh Richardson,23,1,264,14,54,.259,5,25,.200,9,29,.310,.306,11,16,.688,4,22,26,19,8,5,12,35,44,
536,Luke Ridnour,830,493,21623,2933,6803,.431,584,1674,.349,2349,5129,.458,.474,1290,1496,.862,363,1514,1877,3713,814,161,1349,1779,7740,
537,Austin Rivers,252,40,5315,688,1698,.405,136,432,.315,552,1266,.436,.445,296,469,.631,84,390,474,502,150,41,258,500,1808,
538,Andre Roberson,152,126,2663,216,453,.477,40,160,.250,176,293,.601,.521,52,94,.553,146,352,498,121,112,69,93,296,524,
539,Brian Roberts,252,57,4654,684,1659,.412,194,551,.352,490,1108,.442,.471,295,321,.919,51,320,371,653,120,17,239,338,1857,
540,Glenn Robinson III,73,5,703,79,194,.407,15,49,.306,64,145,.441,.446,43,62,.694,26,73,99,32,22,7,25,33,216,
541,Nate Robinson,618,107,13878,2458,5811,.423,811,2255,.360,1647,3556,.463,.493,1080,1357,.796,385,1061,1446,1826,543,42,876,1482,6807,
542,Thomas Robinson,242,4,3219,474,1026,.462,0,4,.000,474,1022,.464,.462,195,367,.531,392,719,1111,125,115,94,241,418,1143,
543,Rajon Rondo,624,571,20453,2848,6085,.468,167,596,.280,2681,5489,.488,.482,954,1573,.606,699,2313,3012,5383,1142,83,1823,1408,6817,
544,Derrick Rose,385,384,13562,2948,6591,.447,332,1110,.299,2616,5481,.477,.472,1407,1729,.814,342,1081,1423,2420,313,153,1131,557,7635,
545,Terrence Ross,282,132,6584,971,2316,.419,449,1196,.375,522,1120,.466,.516,183,230,.796,124,609,733,252,198,84,239,514,2574,
546,Terry Rozier,18,0,106,12,49,.245,2,12,.167,10,37,.270,.265,3,3,1.000,8,11,19,11,0,0,8,11,29,
547,Ricky Rubio,250,230,7879,792,2166,.366,147,476,.309,645,1690,.382,.400,787,976,.806,176,903,1079,2065,563,28,699,640,2518,
548,Damjan Rudez,89,2,1244,138,305,.452,81,202,.401,57,103,.553,.585,22,29,.759,11,47,58,60,17,5,57,100,379,
549,Brandon Rush,405,128,9143,1115,2583,.432,458,1129,.406,657,1454,.452,.520,270,382,.707,165,1085,1250,404,194,229,359,556,2958,
550,D'Angelo Russell,53,22,1434,250,602,.415,81,244,.332,169,358,.472,.483,65,93,.699,30,161,191,176,63,9,128,88,646,
551,Robert Sacre,182,35,2655,306,703,.435,0,1,.000,306,702,.436,.435,138,209,.660,198,364,562,123,54,110,99,325,750,
552,John Salmons,895,429,23672,3007,6979,.431,726,1986,.366,2281,4993,.457,.483,1552,1942,.799,435,2168,2603,2183,756,239,1185,1667,8292,
553,JaKarr Sampson,121,50,1822,232,548,.423,37,161,.230,195,387,.504,.457,125,191,.654,65,227,292,107,49,42,127,226,626,
554,Dennis Schroder,179,16,3254,568,1366,.416,116,352,.330,452,1014,.446,.458,266,335,.794,55,317,372,650,117,9,320,267,1518,
555,Luis Scola,683,480,18094,3528,7135,.494,51,155,.329,3477,6980,.498,.498,1417,1905,.744,1270,3445,4715,1136,448,216,1067,1921,8524,
556,Mike Scott,237,7,3691,695,1479,.470,168,491,.342,527,988,.533,.527,242,309,.783,179,535,714,210,75,24,167,299,1800,
557,Thabo Sefolosha,652,424,15020,1461,3275,.446,374,1090,.343,1087,2185,.497,.503,513,694,.739,495,1995,2490,966,696,294,604,1135,3809,
558,Kevin Seraphin,360,31,5703,1000,2059,.486,0,4,.000,1000,2055,.487,.486,226,317,.713,455,815,1270,213,79,273,411,816,2226,
559,Ramon Sessions,581,137,14277,2148,4914,.437,166,530,.313,1982,4384,.452,.454,1921,2415,.795,310,1345,1655,2501,419,46,1052,838,6383,
560,Mustafa Shakur,25,0,170,21,62,.339,1,11,.091,20,51,.392,.347,9,17,.529,7,15,22,29,5,3,20,17,52,
561,Tornike Shengelia,45,0,247,23,51,.451,1,8,.125,22,43,.512,.461,12,24,.500,13,26,39,17,6,2,23,29,59,
562,Iman Shumpert,270,163,6932,770,1947,.395,270,795,.340,500,1152,.434,.465,234,313,.748,225,729,954,548,347,56,354,684,2044,
563,Alexey Shved,182,25,3271,445,1207,.369,162,529,.306,283,678,.417,.436,297,390,.762,85,270,355,460,110,49,243,201,1349,
564,Xavier Silas,2,0,39,4,15,.267,1,6,.167,3,9,.333,.300,2,3,.667,2,2,4,3,0,0,3,5,11,
565,Jonathon Simmons,39,0,560,86,171,.503,14,34,.412,72,137,.526,.544,47,61,.770,10,51,61,46,15,4,39,78,233,
566,Henry Sims,121,57,2279,370,779,.475,4,23,.174,366,756,.484,.478,196,258,.760,227,371,598,131,67,50,141,252,940,
567,Chris Singleton,148,62,2605,233,620,.376,58,182,.319,175,438,.400,.423,88,139,.633,112,360,472,92,117,57,100,325,612,
568,Kyle Singler,286,169,6916,762,1812,.421,278,745,.373,484,1067,.454,.497,312,390,.800,282,622,904,247,184,101,252,653,2114,
569,Peyton Siva,24,0,224,18,57,.316,7,25,.280,11,32,.344,.377,11,15,.733,2,12,14,34,9,1,18,27,54,
570,Donald Sloan,191,50,3107,368,916,.402,82,268,.306,286,648,.441,.447,147,195,.754,50,327,377,521,67,5,199,156,965,
571,Marcus Smart,101,46,2730,286,783,.365,132,415,.318,154,368,.418,.450,155,224,.692,101,261,362,310,157,29,133,275,859,
572,Chris Smith,2,0,2,0,0,,0,0,,0,0,,,0,0,,0,0,0,0,0,0,0,0,0,
573,Greg Smith,131,12,1642,225,362,.622,0,1,.000,225,361,.623,.622,103,174,.592,153,294,447,35,28,58,58,262,553,
574,Ish Smith,294,46,4303,626,1581,.396,52,197,.264,574,1384,.415,.412,151,233,.648,98,445,543,885,194,44,328,271,1455,
575,Jason Smith,459,96,7994,1218,2606,.467,33,112,.295,1185,2494,.475,.474,452,574,.787,533,1070,1603,359,167,305,399,1020,2921,
576,Josh Smith,879,767,28764,5061,11167,.453,438,1536,.285,4623,9631,.480,.473,2364,3737,.633,1706,4910,6616,2765,1075,1710,2177,2429,12924,
577,J.R. Smith,810,266,21645,3859,9118,.423,1604,4287,.374,2255,4831,.467,.511,1385,1888,.734,433,2189,2622,1794,827,175,1173,1860,10707,
578,Nolan Smith,84,4,829,109,294,.371,19,73,.260,90,221,.407,.403,40,56,.714,24,59,83,97,25,4,71,81,277,
579,Russ Smith,27,0,131,15,47,.319,3,16,.188,12,31,.387,.351,20,26,.769,2,13,15,19,8,1,19,18,53,
580,Tony Snell,199,63,3676,390,978,.399,175,502,.349,215,476,.452,.488,100,124,.806,63,401,464,174,75,40,135,243,1055,
581,James Southerland,4,0,30,5,15,.333,3,6,.500,2,9,.222,.433,1,2,.500,0,8,8,0,1,2,1,3,14,
582,Marreese Speights,542,73,8324,1707,3664,.466,27,102,.265,1680,3562,.472,.470,797,1012,.788,809,1467,2276,327,149,274,479,1181,4238,
583,Tiago Splitter,347,153,6736,1059,1901,.557,0,8,.000,1059,1893,.559,.557,659,947,.696,568,1189,1757,419,197,208,378,677,2777,
584,Nik Stauskas,120,27,2255,231,623,.371,116,353,.329,115,270,.426,.464,95,120,.792,22,174,196,151,47,33,96,159,673,
585,D.J. Stephens,3,0,15,3,7,.429,0,0,,3,7,.429,.429,1,1,1.000,1,4,5,0,0,0,0,0,7,
586,Lance Stephenson,314,186,7840,1051,2348,.448,189,619,.305,862,1729,.499,.488,324,483,.671,213,1105,1318,949,222,39,547,614,2615,
587,Greg Stiemsma,203,42,3048,269,529,.509,0,1,.000,269,528,.509,.509,103,146,.705,190,489,679,97,118,232,143,512,641,
588,David Stockton,3,0,33,2,6,.333,1,2,.500,1,4,.250,.417,3,6,.500,0,2,2,9,2,0,4,1,8,
589,Jarnell Stokes,26,2,144,24,42,.571,0,0,,24,42,.571,.571,16,30,.533,17,21,38,5,6,5,7,26,64,
590,Julyan Stone,47,2,327,22,50,.440,4,19,.211,18,31,.581,.480,13,18,.722,9,39,48,51,12,6,18,35,61,
591,Amar'e Stoudemire,819,670,25847,5840,10892,.536,30,127,.236,5810,10765,.540,.538,4119,5414,.761,1997,4526,6523,1040,627,1032,1928,2626,15829,
592,Rodney Stuckey,587,301,16745,2749,6473,.425,247,826,.299,2502,5647,.443,.444,1967,2379,.827,409,1376,1785,2194,534,92,1100,1270,7712,
593,Jared Sullinger,231,144,5765,1031,2353,.438,130,475,.274,901,1878,.480,.466,366,498,.735,613,1150,1763,411,151,149,298,708,2558,
594,DaJuan Summers,83,7,820,103,268,.384,29,79,.367,74,189,.392,.438,43,67,.642,24,58,82,29,18,8,37,104,278,
595,Walter Tavares,10,0,69,10,18,.556,0,0,,10,18,.556,.556,3,8,.375,7,13,20,2,1,6,5,8,23,
596,Jermaine Taylor,65,12,786,139,315,.441,19,67,.284,120,248,.484,.471,54,74,.730,47,61,108,48,24,8,65,54,351,
597,Jeff Taylor,132,50,2566,299,731,.409,82,257,.319,217,474,.458,.465,127,191,.665,80,183,263,107,72,21,92,234,807,
598,Tyshawn Taylor,61,3,491,63,178,.354,9,25,.360,54,153,.353,.379,39,57,.684,5,28,33,57,25,1,56,54,174,
599,Jeff Teague,491,356,12749,2120,4738,.447,374,1066,.351,1746,3672,.475,.487,1224,1457,.840,149,889,1038,2486,586,164,1059,896,5838,
600,Marquis Teague,88,3,835,81,232,.349,9,41,.220,72,191,.377,.369,35,51,.686,4,80,84,121,19,12,74,93,206,
601,Mirza Teletovic,217,12,3737,592,1455,.407,342,914,.374,250,541,.462,.524,145,195,.744,148,561,709,177,72,63,170,350,1671,
602,Sebastian Telfair,564,193,12149,1542,3953,.390,361,1133,.319,1181,2820,.419,.436,738,950,.777,151,747,898,1960,413,75,859,1196,4183,
603,Garrett Temple,277,87,4333,425,1082,.393,143,440,.325,282,642,.439,.459,200,286,.699,102,358,460,386,194,60,220,423,1193,
604,Jason Terry,1258,675,39355,6692,15032,.445,2134,5623,.380,4558,9409,.484,.516,2732,3232,.845,475,2614,3089,5214,1498,239,2335,2402,18250,
605,Hasheem Thabeet,224,20,2357,182,321,.567,0,0,,182,321,.567,.567,119,206,.578,203,392,595,27,59,184,123,453,483,
606,Adonis Thomas,6,1,37,6,14,.429,1,5,.200,5,9,.556,.464,1,1,1.000,0,3,3,3,0,0,1,6,14,
607,Isaiah Thomas,338,206,9786,1836,4201,.437,561,1558,.360,1275,2643,.482,.504,1367,1575,.868,187,670,857,1685,334,28,752,739,5600,
608,Lance Thomas,218,61,3896,442,1002,.441,44,113,.389,398,889,.448,.463,261,330,.791,188,358,546,143,78,29,164,350,1189,
609,Malcolm Thomas,40,0,329,30,69,.435,1,11,.091,29,58,.500,.442,15,25,.600,27,69,96,14,6,7,25,30,76,
610,Tyrus Thomas,402,129,7932,1147,2620,.438,8,34,.235,1139,2586,.440,.439,791,1080,.732,550,1388,1938,347,328,525,527,989,3093,
611,Hollis Thompson,199,66,4891,559,1317,.424,271,684,.396,288,633,.455,.527,153,218,.702,158,456,614,212,130,54,186,403,1542,
612,Jason Thompson,567,406,14519,2080,4188,.497,1,27,.037,2079,4161,.500,.497,960,1466,.655,1241,2557,3798,625,274,402,739,1711,5121,
613,Klay Thompson,356,319,11507,2373,5304,.447,945,2257,.419,1428,3047,.469,.536,714,844,.846,140,1010,1150,831,323,196,640,848,6405,
614,Tristan Thompson,358,226,10243,1370,2761,.496,0,6,.000,1370,2755,.497,.496,766,1215,.630,1216,1852,3068,284,179,252,434,874,3506,
615,Marcus Thornton,436,132,10500,1998,4686,.426,689,1917,.359,1309,2769,.473,.500,728,876,.831,378,859,1237,617,373,57,455,674,5413,
616,Jamaal Tinsley,547,404,14443,1759,4481,.393,397,1326,.299,1362,3155,.432,.437,737,1029,.716,345,1260,1605,3330,776,155,1375,1306,4652,
617,Anthony Tolliver,436,66,8633,891,2174,.410,458,1281,.358,433,893,.485,.515,410,530,.774,384,1168,1552,384,164,137,266,728,2650,
618,Karl-Anthony Towns,54,54,1627,380,699,.544,18,48,.375,362,651,.556,.557,144,169,.852,150,397,547,78,34,98,113,162,922,
619,Nikoloz Tskitishvili,172,16,1946,190,626,.304,43,183,.235,147,443,.332,.338,84,115,.730,109,198,307,114,46,50,126,227,507,
620,P.J. Tucker,309,241,8488,886,2020,.439,227,640,.355,659,1380,.478,.495,388,519,.748,508,1202,1710,477,350,79,340,672,2387,
621,Ronny Turiaf,473,105,8020,856,1607,.533,0,7,.000,856,1600,.535,.533,497,782,.636,520,1237,1757,618,181,593,358,1116,2209,
622,Evan Turner,443,233,12612,1901,4430,.429,175,589,.297,1726,3841,.449,.449,744,959,.776,262,2022,2284,1647,358,96,877,917,4721,
623,Myles Turner,31,8,628,131,246,.533,0,2,.000,131,244,.537,.533,46,71,.648,37,117,154,15,8,43,25,72,308,
624,Jeremy Tyler,104,23,1034,157,349,.450,0,1,.000,157,348,.451,.450,59,106,.557,98,171,269,25,23,42,68,164,373,
625,Ekpe Udoh,270,52,4564,409,953,.429,0,3,.000,409,950,.431,.429,254,353,.720,361,499,860,179,124,324,189,573,1072,
626,Beno Udrih,789,272,17586,2644,5711,.463,453,1299,.349,2191,4412,.497,.503,974,1173,.830,301,1350,1651,2722,563,71,1138,1243,6715,
627,Jonas Valanciunas,258,252,6777,1103,1998,.552,0,2,.000,1103,1996,.553,.552,659,853,.773,676,1431,2107,171,89,285,393,748,2865,
628,Anderson Varejao,591,208,14773,1778,3472,.512,1,42,.024,1777,3430,.518,.512,928,1469,.632,1479,2955,4434,709,529,397,578,1579,4485,
629,Jarvis Varnado,37,0,397,39,67,.582,0,0,,39,67,.582,.582,29,56,.518,21,51,72,16,11,31,16,72,107,
630,Greivis Vasquez,391,157,9382,1370,3263,.420,407,1158,.351,963,2105,.457,.482,421,514,.819,124,885,1009,1910,232,33,742,752,3568,
631,Rashad Vaughn,45,0,527,41,130,.315,25,71,.352,16,59,.271,.412,8,9,.889,8,46,54,16,14,7,17,39,115,
632,Jan Vesely,162,25,2455,263,505,.521,0,2,.000,263,503,.523,.521,64,157,.408,225,337,562,96,107,84,123,384,590,
633,Charlie Villanueva,638,163,13441,2625,6027,.436,702,2061,.341,1923,3966,.485,.494,782,1015,.770,788,2197,2985,545,324,345,644,1440,6734,
634,Noah Vonleh,75,39,1060,105,251,.418,9,38,.237,96,213,.451,.436,44,58,.759,93,200,293,29,27,24,39,119,263,
635,Nikola Vucevic,308,271,9277,1959,3851,.509,6,24,.250,1953,3827,.510,.509,441,606,.728,926,2111,3037,571,234,269,525,845,4365,
636,Sasha Vujacic,516,37,8078,978,2500,.391,480,1311,.366,498,1189,.419,.487,381,441,.864,183,780,963,657,310,29,294,807,2817,
637,Dwyane Wade,831,821,29814,7150,14634,.489,386,1345,.287,6764,13289,.509,.502,5062,6614,.765,1057,2969,4026,4835,1387,743,2811,1929,19748,
638,Dion Waiters,264,104,7536,1338,3244,.412,285,857,.333,1053,2387,.441,.456,514,727,.707,120,566,686,659,266,63,468,523,3475,
639,Henry Walker,181,35,3016,386,865,.446,190,515,.369,196,350,.560,.556,117,154,.760,55,346,401,153,93,27,142,375,1079,
640,Kemba Walker,335,290,11245,2000,5001,.400,469,1436,.327,1531,3565,.429,.447,1215,1480,.821,207,1065,1272,1787,489,144,703,521,5684,
641,Gerald Wallace,832,611,24731,3516,7492,.469,407,1303,.312,3109,6189,.502,.496,2494,3517,.709,1145,3693,4838,1725,1200,681,1486,1829,9933,
642,John Wall,395,383,14212,2574,5976,.431,297,938,.317,2277,5038,.452,.456,1644,2086,.788,223,1513,1736,3487,671,254,1482,935,7089,
643,Casper Ware,9,0,116,18,42,.429,7,21,.333,11,21,.524,.512,5,6,.833,0,9,9,10,8,0,5,11,48,
644,T.J. Warren,87,5,1684,334,655,.510,33,91,.363,301,564,.534,.535,59,83,.711,98,134,232,69,55,25,59,145,760,
645,C.J. Watson,513,93,10581,1387,3270,.424,430,1126,.382,957,2144,.446,.490,755,938,.805,196,821,1017,1308,505,60,584,771,3959,
646,Maalik Wayns,29,1,211,27,90,.300,7,31,.226,20,59,.339,.339,17,19,.895,1,8,9,29,8,0,15,30,78,
647,David Wear,2,0,7,0,2,.000,0,1,.000,0,1,.000,.000,0,0,,2,0,2,1,0,0,0,1,0,
648,Travis Wear,51,1,672,84,209,.402,11,30,.367,73,179,.408,.428,20,26,.769,31,75,106,40,15,11,35,55,199,
649,Martell Webster,580,266,13914,1696,4062,.418,790,2067,.382,906,1995,.454,.515,874,1105,.791,352,1459,1811,588,299,160,536,1055,5056,
650,Sonny Weems,171,47,3201,502,1074,.467,32,109,.294,470,965,.487,.482,126,177,.712,86,301,387,249,83,27,191,256,1162,
651,Russell Westbrook,560,543,19059,4210,9696,.434,467,1545,.302,3743,8151,.459,.458,3111,3798,.819,924,2136,3060,4149,983,159,2067,1357,11998,
652,David West,867,738,26779,5263,10713,.491,49,195,.251,5214,10518,.496,.494,2443,2983,.819,1642,4403,6045,1935,656,705,1481,2139,13018,
653,D.J. White,138,11,2111,348,687,.507,1,3,.333,347,684,.507,.507,113,157,.720,117,320,437,80,39,57,65,199,810,
654,Hassan Whiteside,112,72,2524,484,785,.617,0,0,,484,785,.617,.617,174,333,.523,297,718,1015,21,54,313,152,257,1142,
655,Royce White,3,0,9,0,1,.000,0,0,,0,1,.000,.000,0,0,,0,0,0,0,0,0,0,2,0,
656,Shayne Whittington,24,0,118,21,45,.467,1,6,.167,20,39,.513,.478,18,23,.783,11,21,32,8,6,3,7,21,61,
657,Andrew Wiggins,135,135,4831,889,2014,.441,70,253,.277,819,1761,.465,.459,639,849,.753,216,353,569,266,129,82,291,306,2487,
658,C.J. Wilcox,29,0,124,19,50,.380,7,20,.350,12,30,.400,.450,2,2,1.000,1,8,9,10,3,1,10,8,47,
659,Damien Wilkins,563,149,10839,1331,3118,.427,201,609,.330,1130,2509,.450,.459,708,904,.783,436,910,1346,787,429,129,519,938,3571,
660,Deron Williams,762,708,26579,4519,10145,.445,1061,2973,.357,3458,7172,.482,.498,2735,3329,.822,333,2083,2416,6328,819,194,2220,1944,12834,
661,Derrick Williams,350,92,7531,1125,2622,.429,200,691,.289,925,1931,.479,.467,789,1107,.713,318,1147,1465,236,176,98,343,451,3239,
662,Elliot Williams,109,2,1470,193,458,.421,54,174,.310,139,284,.489,.480,97,145,.669,38,123,161,94,45,6,78,158,537,
663,Lou Williams,686,88,16084,2712,6534,.415,758,2227,.340,1954,4307,.454,.473,2197,2684,.819,249,1159,1408,2005,600,119,966,952,8379,
664,Mo Williams,811,525,23811,4041,9300,.435,1087,2877,.378,2954,6423,.460,.493,1563,1795,.871,405,1852,2257,3985,718,121,1846,2001,10732,
665,Marvin Williams,757,570,21800,2839,6389,.444,538,1552,.347,2301,4837,.476,.486,1668,2078,.803,962,2951,3913,981,576,373,790,1598,7884,
666,Marcus Williams,13,0,39,7,22,.318,0,0,,7,22,.318,.318,0,0,,4,8,12,3,1,1,0,4,14,
667,Reggie Williams,200,32,3657,591,1290,.458,194,534,.363,397,756,.525,.533,195,261,.747,103,384,487,297,85,13,142,239,1571,
668,Shawne Williams,314,58,5368,650,1612,.403,275,812,.339,375,800,.469,.489,194,257,.755,247,698,945,220,127,156,197,656,1769,
669,Justise Winslow,50,3,1388,110,263,.418,23,89,.258,87,174,.500,.462,43,60,.717,42,211,253,66,37,18,67,118,286,
670,Jeff Withey,133,13,1501,173,325,.532,0,2,.000,173,323,.536,.532,124,176,.705,120,242,362,54,38,116,58,160,470,
671,Nate Wolters,79,31,1556,190,446,.426,18,69,.261,172,377,.456,.446,61,96,.635,41,142,183,208,43,17,70,85,459,
672,Christian Wood,14,0,114,19,43,.442,4,9,.444,15,34,.441,.488,9,13,.692,10,22,32,3,5,5,2,9,51,
673,Brandan Wright,367,54,6029,1112,1836,.606,0,11,.000,1112,1825,.609,.606,387,570,.679,514,854,1368,169,170,374,178,488,2611,
674,Chris Wright,32,1,312,44,80,.550,0,1,.000,44,79,.557,.550,30,46,.652,29,36,65,9,14,18,13,39,118,
675,Delon Wright,14,0,41,4,14,.286,2,3,.667,2,11,.182,.357,3,6,.500,1,6,7,4,1,0,3,3,13,
676,Dorell Wright,549,222,12280,1657,3908,.424,617,1691,.365,1040,2217,.469,.503,666,826,.806,375,1718,2093,850,418,271,475,790,4597,
677,Tony Wroten,145,34,3076,575,1393,.413,84,363,.231,491,1030,.477,.443,370,572,.647,106,257,363,437,137,28,375,268,1604,
678,James Young,51,0,493,46,133,.346,22,87,.253,24,46,.522,.429,17,33,.515,12,52,64,20,13,3,8,35,131,
679,Joseph Young,28,0,255,42,107,.393,8,29,.276,34,78,.436,.430,18,23,.783,5,25,30,41,11,0,21,19,110,
680,Nick Young,566,131,13227,2399,5720,.419,730,1963,.372,1669,3757,.444,.483,1210,1452,.833,213,931,1144,582,317,111,628,1063,6738,
681,Sam Young,249,52,3966,560,1266,.442,49,175,.280,511,1091,.468,.462,267,360,.742,163,410,573,180,134,57,204,311,1436,
682,Thaddeus Young,646,416,19710,3834,7717,.497,251,785,.320,3583,6932,.517,.513,1044,1520,.687,1287,2458,3745,967,910,252,938,1422,8963,
683,Cody Zeller,189,80,4020,486,1065,.456,2,12,.167,484,1053,.460,.457,383,514,.745,297,697,994,234,113,122,192,462,1357,
684,Tyler Zeller,266,126,5184,822,1628,.505,0,5,.000,822,1623,.506,.505,395,511,.773,442,842,1284,262,79,169,264,649,2039,
